value	form	character	language
LAK797	A	𒀀	sux
MZL839	A	𒀀	sux
)u4	A	𒀀	sux
a	A	𒀀	sux
aia2	A	𒀀	sux
aya2	A	𒀀	sux
barx	A	𒀀	sux
bunijx	A	𒀀	sux
burx	A	𒀀	sux
dur5	A	𒀀	sux
duru5	A	𒀀	sux
e4	A	𒀀	sux
ea	A	𒀀	sux
ebir3	A	𒀀	sux
emx	A	𒀀	sux
epir3	A	𒀀	sux
ec10	A	𒀀	sux
ja10	A	𒀀	sux
ia10	A	𒀀	sux
id5	A	𒀀	sux
me5	A	𒀀	sux
mu14	A	𒀀	sux
sedx	A	𒀀	sux
cegx	A	𒀀	sux
tur5	A	𒀀	sux
ya10	A	𒀀	sux
ai	|A.A|	𒀀𒀀	sux
aia	|A.A|	𒀀𒀀	sux
aya	|A.A|	𒀀𒀀	sux
aye	|A.A|	𒀀𒀀	sux
ayi	|A.A|	𒀀𒀀	sux
ayu	|A.A|	𒀀𒀀	sux
ayya	|A.A|	𒀀𒀀	sux
ayye	|A.A|	𒀀𒀀	sux
ayyi	|A.A|	𒀀𒀀	sux
ayyu	|A.A|	𒀀𒀀	sux
iya	|A.A|	𒀀𒀀	sux
iyi	|A.A|	𒀀𒀀	sux
iyu	|A.A|	𒀀𒀀	sux
iyya	|A.A|	𒀀𒀀	sux
iyyi	|A.A|	𒀀𒀀	sux
iyyu	|A.A|	𒀀𒀀	sux
yax	|A.A|	𒀀𒀀	sux
ayayax	|A.A.A|	𒀀𒀀𒀀	sux
a4	|A.AN|	𒀀𒀭	sux
am3	|A.AN|	𒀀𒀭	sux
ce7	|A.AN|	𒀀𒀭	sux
ceg3	|A.AN|	𒀀𒀭	sux
cej3	|A.AN|	𒀀𒀭	sux
cemx	|A.AN|	𒀀𒀭	sux
a-ra2	|A.DU|	𒀀𒁺	sux
tuce	|A.DU|	𒀀𒁺	sux
tuccuru	|A.DU|	𒀀𒁺	sux
eribx	|A.EDIN|	𒀀𒂔	sux
eru4	|A.EDIN|	𒀀𒂔	sux
erua	|A.EDIN|	𒀀𒂔	sux
erum4	|A.EDIN|	𒀀𒂔	sux
ummux	|A.EDIN|	𒀀𒂔	sux
ummudx	|A.EDIN|	𒀀𒂔	sux
ummu3	|A.EDIN.LAL|	𒀀𒂔𒇲	sux
ummud	|A.EDIN.LAL|	𒀀𒂔𒇲	sux
ummu~b	|A.EDIN.A.LAL|	𒀀𒂔𒀀𒇲	sux
ummux~c	|A.U.EDIN.LAL|	𒀀𒌋𒂔𒇲	sux
ummudx~c	|A.U.EDIN.LAL|	𒀀𒌋𒂔𒇲	sux
ummux~d	|EDIN.A|	𒂔𒀀	sux
ummux~e	|EDIN.A.LAL|	𒂔𒀀𒇲	sux
ummux~f	|EDIN.LAL.A|	𒂔𒇲𒀀	sux
ugar	|A.GAR₃|	𒀀𒃼	sux
a-gar3	|A.GAR₃|	𒀀𒃼	sux
adar	|A.GUD×KUR|	𒀀𒄠	sux
ildagx	|A.GUD×KUR|	𒀀𒄠	sux
kuar2	|A.HA|	𒀀𒄩	sux
kuara2	|A.HA|	𒀀𒄩	sux
[...]ri	|A.HA|	𒀀𒄩	sux
sahx	|A.HA|	𒀀𒄩	sux
tuba2	|A.HA|	𒀀𒄩	sux
zahx	|A.HA|	𒀀𒄩	sux
sahx	|A.HA.A|	𒀀𒄩𒀀	sux
zahx	|A.HA.A|	𒀀𒄩𒀀	sux
girim3	|A.HA.TAR.DU|	𒀀𒄩𒋻𒁺	sux
girima3	|A.HA.TAR.DU|	𒀀𒄩𒋻𒁺	sux
girimma3	|A.HA.TAR.DU|	𒀀𒄩𒋻𒁺	sux
girin2	|A.HA.TAR.DU|	𒀀𒄩𒋻𒁺	sux
nun2	|A.HA.TAR.DU|	𒀀𒄩𒋻𒁺	sux
liq3	|A.HU.SI|	𒀀𒄷𒋛	sux
er2	|A.IGI|	𒀀𒅆	sux
era2	|A.IGI|	𒀀𒅆	sux
esec	|A.IGI|	𒀀𒅆	sux
esic3	|A.IGI|	𒀀𒅆	sux
ec9	|A.IGI|	𒀀𒅆	sux
ir2	|A.IGI|	𒀀𒅆	sux
ira2	|A.IGI|	𒀀𒅆	sux
isic2	|A.IGI|	𒀀𒅆	sux
cecx	|A.IGI|	𒀀𒅆	sux
uga2	|A.KA|	𒀀𒅗	sux
ugu2	|A.KA|	𒀀𒅗	sux
ela	|A.KAL|	𒀀𒆗	sux
ella	|A.KAL|	𒀀𒆗	sux
illu	|A.KAL|	𒀀𒆗	sux
akcak2	|A.KUŠU₂|	𒀀𒆵	sux
enigin	|A.LAGAB.LAGAB|	𒀀𒆸𒆸	sux
bunijx	|A.LAGAB×A|	𒀀𒆹	sux
buninx	|A.LAGAB×A|	𒀀𒆹	sux
ix	|A.LAGAB×A|	𒀀𒆹	sux
i7	|A.LAGAB×HAL|	𒀀𒇉	sux
id2	|A.LAGAB×HAL|	𒀀𒇉	sux
ida2	|A.LAGAB×HAL|	𒀀𒇉	sux
it2	|A.LAGAB×HAL|	𒀀𒇉	sux
ita5	|A.LAGAB×HAL|	𒀀𒇉	sux
iti5	|A.LAGAB×HAL|	𒀀𒇉	sux
itu5	|A.LAGAB×HAL|	𒀀𒇉	sux
ix~a	|A.LAGAB×A|	𒀀𒆹	sux
id7	|A.LAGAB×HAL.DI|	𒀀𒇉𒁲	sux
id6	|A.LAGAB×HAL.GAL|	𒀀𒇉𒃲	sux
azadx	|A.LAGAB×HAL.ŠU₂|	𒀀𒇉𒋙	sux
azadx	|A.LAGAB×HAL.X|	𒀀𒇉░░	sux
darengal	|A.LAGAB×HAL.UD.NUN.KI|	𒀀𒇉𒌓𒉣𒆠	sux
icuruengal	|A.LAGAB×HAL.UD.NUN.KI|	𒀀𒇉𒌓𒉣𒆠	sux
surengal	|A.LAGAB×HAL.UD.NUN.KI|	𒀀𒇉𒌓𒉣𒆠	sux
surgal	|A.LAGAB×HAL.UD.NUN.KI|	𒀀𒇉𒌓𒉣𒆠	sux
turungal	|A.LAGAB×HAL.UD.NUN.KI|	𒀀𒇉𒌓𒉣𒆠	sux
esir	|A.LAGAB×KUL|	𒀀𒇒	sux
ecer	|A.LAGAB×KUL|	𒀀𒇒	sux
kuninx	|A.LAGAB×KUL|	𒀀𒇒	sux
sarx	|A.LAGAB×KUL|	𒀀𒇒	sux
arinax	|A.LU₂@s.NA|	𒀀𒈕𒈾	sux
a-rin4-na	|A.LU₂@s.NA|	𒀀𒈕𒈾	sux
a-gar5	|A.LU₃|	𒀀𒈖	sux
kunigara5	|A.LU₃|	𒀀𒈖	sux
aslumx	|A.LUM|	𒀀𒈝	sux
ega	|A.MI.A|	𒀀𒈪𒀀	sux
cex	|A.MUŠ|	𒀀𒈲	sux
a)u)u	|A.PA.GISAL.PAD.SI.A|	𒀀𒉺𒄐𒉻𒋛𒀀	sux
addir	|A.PA.GISAL.PAD.SI.A|	𒀀𒉺𒄐𒉻𒋛𒀀	sux
au	|A.PA.GISAL.PAD.SI.A|	𒀀𒉺𒄐𒉻𒋛𒀀	sux
iddir	|A.PA.GISAL.PAD.SI.A|	𒀀𒉺𒄐𒉻𒋛𒀀	sux
samanx	|A.PA.GISAL.PAD.SI.A|	𒀀𒉺𒄐𒉻𒋛𒀀	sux
samanx	|A.PA.BI.SI.A.GA|	𒀀𒉺𒁉𒋛𒀀𒂵	sux
ugu3	|A.SAG|	𒀀𒊕	sux
epigx	|A.SIG|	𒀀𒋝	sux
aktum	|A.SU|	𒀀𒋢	sux
bir8	|A.SUD|	𒀀𒋤	sux
kacbirx	|A.SUD|	𒀀𒋤	sux
tu17	|A.ŠU.NAGA|	𒀀𒋗𒉀	sux
ceg4	|A.ŠU₂.NAGA|	𒀀𒋙𒉀	sux
ebla	|A.TAR.A.AN|	𒀀𒋻𒀀𒀭	sux
asi	|A.ŠE.NUN&NUN|	𒀀𒊺𒉪	sux
eca	|A.ŠE.NUN&NUN|	𒀀𒊺𒉪	sux
ece4	|A.ŠE.NUN&NUN|	𒀀𒊺𒉪	sux
asal2	|A.TU.GABA.LIŠ|	𒀀𒌅𒃮𒇺	sux
asar2	|A.TU.GABA.LIŠ|	𒀀𒌅𒃮𒇺	sux
acalx	|A.TU.GABA.LIŠ|	𒀀𒌅𒃮𒇺	sux
acar2	|A.TU.GABA.LIŠ|	𒀀𒌅𒃮𒇺	sux
azalx	|A.TU.GABA.LIŠ|	𒀀𒌅𒃮𒇺	sux
LAK212~a	ASAL₂	𒀷	sux
edamu	|A.TUR|	𒀀𒌉	sux
ugux	|A.U.KA|	𒀀𒌋𒅗	sux
ackudx	|A.ZA.AN.MUŠ₃|	𒀀𒍝𒀭𒈹	sux
ackix	|A.ZI&ZI|	𒀀𒍤	sux
ginx	|A.ZI&ZI|	𒀀𒍤	sux
gugx	|A.ZI&ZI|	𒀀𒍤	sux
lamahucx	|A.ZI&ZI|	𒀀𒍤	sux
mudx	|A.ZI&ZI|	𒀀𒍤	sux
numunx	|A.ZI&ZI|	𒀀𒍤	sux
suluhux	|A.ZI&ZI|	𒀀𒍤	sux
cubx	|A.ZI&ZI|	𒀀𒍤	sux
/cumun/	|A.ZI&ZI|	𒀀𒍤	sux
zukumx	|A.ZI&ZI|	𒀀𒍤	sux
aya2-aya2	|A×A|	𒀁	sux
edur	|A×A|	𒀁	sux
eduru	|A×A|	𒀁	sux
agam	|A×BAD|	𒀂	sux
LAK800	|A×GAN₂@t|	𒀃	sux
LAK796	|A×HA|	𒀄	sux
sah7	|A×HA|	𒀄	sux
saha7	|A×HA|	𒀄	sux
zah3	|A×HA|	𒀄	sux
zaha3	|A×HA|	𒀄	sux
er6	|A×IGI|	𒀅	sux
ir6	|A×IGI|	𒀅	sux
isic3	|A×IGI|	𒀅	sux
cec3	|A×IGI|	𒀅	sux
cedu3	|A×LAGAR@g|	𒀆	sux
amuc	|A×MUŠ|	𒀇	sux
amuca	|A×MUŠ|	𒀇	sux
emuc	|A×MUŠ|	𒀇	sux
esag	|A×SAG|	𒀈	sux
esaj	|A×SAG|	𒀈	sux
LAK140	A₂	𒀉	sux
MZL560	A₂	𒀉	sux
a2	A₂	𒀉	sux
ah5	A₂	𒀉	sux
ahi2	A₂	𒀉	sux
ed	A₂	𒀉	sux
et	A₂	𒀉	sux
et	A₂	𒀉	sux
id	A₂	𒀉	sux
idi2	A₂	𒀉	sux
it	A₂	𒀉	sux
it	A₂	𒀉	sux
te8	A₂	𒀉	sux
ti8	A₂	𒀉	sux
liri5	|A₂.AŠ|	𒀉𒀸	sux
liru5	|A₂.AŠ|	𒀉𒀸	sux
lirum5	|A₂.AŠ|	𒀉𒀸	sux
arhuc7	|A₂.GA₂×SAL|	𒀉𒃣	sux
liri4	|A₂.KAL|	𒀉𒆗	sux
liru4	|A₂.KAL|	𒀉𒆗	sux
lirum4	|A₂.KAL|	𒀉𒆗	sux
usu	|A₂.KAL|	𒀉𒆗	sux
uccux	|A₂.KAL|	𒀉𒆗	sux
ackud2	|A₂.MUŠ₃|	𒀉𒈹	sux
ackud	|A₂.MUŠ₃@g|	𒀉𒈽	sux
azag2	|A₂.PA|	𒀉𒉺	sux
arhuc6	|A₂.SAL|	𒀉𒊩	sux
arhuc5	|A₂.TUR|	𒀉𒌉	sux
acita	|A₂.U.KID|	𒀉𒌋𒆤	sux
acte	|A₂.U.KID|	𒀉𒌋𒆤	sux
ehe	|A₂.UD.DU|	𒀉𒌓𒁺	sux
ehi	|A₂.UD.DU|	𒀉𒌓𒁺	sux
ackudx	|A₂.ZA.MUŠ₃@g|	𒀉𒍝𒈽	sux
MZL635	ALEPH	𒀪	sux
)	ALEPH	𒀪	sux
)a	ALEPH	𒀪	sux
)e	ALEPH	𒀪	sux
)i	ALEPH	𒀪	sux
)u	ALEPH	𒀪	sux
a)	ALEPH	𒀪	sux
ah4	ALEPH	𒀪	sux
e)	ALEPH	𒀪	sux
eh2	ALEPH	𒀪	sux
i)	ALEPH	𒀪	sux
ih2	ALEPH	𒀪	sux
u)	ALEPH	𒀪	sux
uh5	ALEPH	𒀪	sux
umun4	ALEPH	𒀪	sux
MZL223	AB	𒀊	sux
LAK536	AB	𒀊	sux
ab	AB	𒀊	sux
aba	AB	𒀊	sux
abba	AB	𒀊	sux
agarinx	AB	𒀊	sux
ap	AB	𒀊	sux
acx	AB	𒀊	sux
eri12	AB	𒀊	sux
es3	AB	𒀊	sux
esa3	AB	𒀊	sux
ec3	AB	𒀊	sux
eca3	AB	𒀊	sux
ecex	AB	𒀊	sux
es,3	AB	𒀊	sux
ez3	AB	𒀊	sux
giraba	AB	𒀊	sux
iri12	AB	𒀊	sux
is3	AB	𒀊	sux
ic7	AB	𒀊	sux
is,3	AB	𒀊	sux
iz3	AB	𒀊	sux
unu5	AB	𒀊	sux
girabax	|AB.HA@g|	𒀊𒄫	sux
essadu	|AB.HA.ZAG.GABA.HU|	𒀊𒄩𒍠𒃮𒄷	sux
ecsadu	|AB.HA.ZAG.GABA.HU|	𒀊𒄩𒍠𒃮𒄷	sux
sugal6	|AB.MUŠ₃|	𒀊𒈹	sux
zabala6	|AB.MUŠ₃|	𒀊𒈹	sux
zabalam6	|AB.MUŠ₃|	𒀊𒈹	sux
absin2	|AB.NAM|	𒀊𒉆	sux
LAK540	|AB×AŠ₂|	𒀋	sux
abba2	|AB×AŠ₂|	𒀋	sux
agarin	|AB×DUN₃@g|	𒀌	sux
ajarin	|AB×DUN₃@g|	𒀌	sux
erigal	|AB×GAL|	𒀍	sux
ecgal	|AB×GAL|	𒀍	sux
irigal	|AB×GAL|	𒀍	sux
unugi2	|AB×GAL|	𒀍	sux
urugal	|AB×GAL|	𒀍	sux
agarin2	|AB×GAN₂@t|	𒀎	sux
ajarin2	|AB×GAN₂@t|	𒀎	sux
LAK543	|AB×HA|	𒀏	sux
nance	|AB×HA|	𒀏	sux
nacce	|AB×HA|	𒀏	sux
nazi	|AB×HA|	𒀏	sux
nigin6	|AB×HA|	𒀏	sux
nijin6	|AB×HA|	𒀏	sux
nina	|AB×HA|	𒀏	sux
sirara	|AB×HA|	𒀏	sux
siraran	|AB×HA|	𒀏	sux
ecemen4	|AB×IMIN|	𒀑	sux
ecemin4	|AB×IMIN|	𒀑	sux
niginx	|AB×LAGAB|	𒀒	sux
unugi	|AB×IGI@g|	𒀐	sux
ze4	|AB×ŠEŠ|	𒀓	sux
zi4	|AB×ŠEŠ|	𒀓	sux
erimx	|AB×(U.U.U)|	𒀔	sux
gunx	|AB×(U.U.U)|	𒀔	sux
gunux	|AB×(U.U.U)|	𒀔	sux
nux	|AB×(U.U.U)|	𒀔	sux
sirarax	|AB×(U.U.U)|	𒀔	sux
unux	|AB×(U.U.U)|	𒀔	sux
unugx	|AB×(U.U.U)|	𒀔	sux
urugalx	|AB×(U.U.U)|	𒀔	sux
urukx	|AB×(U.U.U)|	𒀔	sux
LAK537	AB@g	𒀕	sux
ab4	AB@g	𒀕	sux
aba4	AB@g	𒀕	sux
eri11	AB@g	𒀕	sux
erim5	AB@g	𒀕	sux
erin5	AB@g	𒀕	sux
gun4	AB@g	𒀕	sux
guna4	AB@g	𒀕	sux
gunu4	AB@g	𒀕	sux
iri11	AB@g	𒀕	sux
irigal2	AB@g	𒀕	sux
nu7	AB@g	𒀕	sux
sirara5	AB@g	𒀕	sux
unu	AB@g	𒀕	sux
unug	AB@g	𒀕	sux
urugal2	AB@g	𒀕	sux
uruk	AB@g	𒀕	sux
zabalax	|AB@g.MUŠ₃.ZA|	𒀕𒈹𒍝	sux
LAK403	AB₂	𒀖	sux
ab2	AB₂	𒀖	sux
ap2	AB₂	𒀖	sux
le8	AB₂	𒀖	sux
let	AB₂	𒀖	sux
li8	AB₂	𒀖	sux
lid	AB₂	𒀖	sux
lit	AB₂	𒀖	sux
liti	AB₂	𒀖	sux
lit	AB₂	𒀖	sux
liti	AB₂	𒀖	sux
rem2	AB₂	𒀖	sux
reme2	AB₂	𒀖	sux
rim2	AB₂	𒀖	sux
rimu2	AB₂	𒀖	sux
munux	|AB₂.KU|	𒀖𒆪	sux
nagadx	|AB₂.KU|	𒀖𒆪	sux
udul	|AB₂.KU|	𒀖𒆪	sux
unu3	|AB₂.KU|	𒀖𒆪	sux
unud	|AB₂.KU|	𒀖𒆪	sux
utul	|AB₂.KU|	𒀖𒆪	sux
udul10	|AB₂.LU|	𒀖𒇻	sux
utul10	|AB₂.LU|	𒀖𒇻	sux
LAK404	|AB₂.ŠA₃|	𒀖𒊮	sux
girx	|AB₂.ŠA₃|	𒀖𒊮	sux
kirx	|AB₂.ŠA₃|	𒀖𒊮	sux
libicx	|AB₂.ŠA₃|	𒀖𒊮	sux
lipicx	|AB₂.ŠA₃|	𒀖𒊮	sux
cagx	|AB₂.ŠA₃|	𒀖𒊮	sux
cemx	|AB₂.ŠA₃|	𒀖𒊮	sux
ubx	|AB₂.ŠA₃|	𒀖𒊮	sux
lilis	|AB₂×BALAG|	𒀗	sux
liliz	|AB₂×BALAG|	𒀗	sux
kir6	|AB₂×GAN₂@t|	𒀘	sux
qir6	|AB₂×GAN₂@t|	𒀘	sux
cem5	|AB₂×GAN₂@t|	𒀘	sux
meze	|AB₂×(ME.EN)|	𒀙	sux
cem4	|AB₂×(ME.EN)|	𒀙	sux
ub6	|AB₂×(ME.EN)|	𒀙	sux
gir9	|AB₂×ŠA₃|	𒀚	sux
kir2	|AB₂×ŠA₃|	𒀚	sux
kiri9	|AB₂×ŠA₃|	𒀚	sux
libic	|AB₂×ŠA₃|	𒀚	sux
lipic	|AB₂×ŠA₃|	𒀚	sux
cagx	|AB₂×ŠA₃|	𒀚	sux
cem3	|AB₂×ŠA₃|	𒀚	sux
ub3	|AB₂×ŠA₃|	𒀚	sux
girx	|AB₂×TAK₄|	𒀛	sux
kirx	|AB₂×TAK₄|	𒀛	sux
libicx	|AB₂×TAK₄|	𒀛	sux
cagx	|AB₂×TAK₄|	𒀛	sux
cem6	|AB₂×TAK₄|	𒀛	sux
ub5	|AB₂×TAK₄|	𒀛	sux
uba5	|AB₂×TAK₄|	𒀛	sux
LAK635	AD	𒀜	sux
ab3	AD	𒀜	sux
aba3	AD	𒀜	sux
ad	AD	𒀜	sux
ada	AD	𒀜	sux
ap3	AD	𒀜	sux
at	AD	𒀜	sux
at	AD	𒀜	sux
ad-kidx	|AD.E₂|	𒀜𒂍	sux
akkilx	|AD.E₂|	𒀜𒂍	sux
ad-kid	|AD.KID|	𒀜𒆤	sux
akkil2	|AD.KID|	𒀜𒆤	sux
akkilx	|AD.KU|	𒀜𒆪	sux
LAK87	AK	𒀝	sux
MZL127	AK	𒀝	sux
a5	AK	𒀝	sux
ag	AK	𒀝	sux
aj	AK	𒀝	sux
ak	AK	𒀝	sux
aka	AK	𒀝	sux
akix	AK	𒀝	sux
aq	AK	𒀝	sux
aqa	AK	𒀝	sux
ke3	AK	𒀝	sux
ki3	AK	𒀝	sux
kid3	AK	𒀝	sux
me6	AK	𒀝	sux
na3	AK	𒀝	sux
ra6	AK	𒀝	sux
ca5	AK	𒀝	sux
MZL129	|AK×ERIN₂|	𒀞	sux
me3	|AK×ERIN₂|	𒀞	sux
MZL53~a	|KA×ERIN₂|	𒅠	sux
mex~a	|KA×ERIN₂|	𒅠	sux
LAK87~c	AK	𒀝	sux
MZL127~c	AK	𒀝	sux
me6~c	AK	𒀝	sux
me11~d	|AK×(ŠITA.GIŠ)|	𒀟	sux
LAK515	AL	𒀠	sux
al	AL	𒀠	sux
ala3	AL	𒀠	sux
il10	AL	𒀠	sux
mah2	AL	𒀠	sux
maha2	AL	𒀠	sux
ilx	|AL.ŠE|	𒀠𒊺	sux
bal3	|AL×AL|	𒀡	sux
lidim	|AL×DIM₂|	𒀢	sux
gicbar	|AL×GIŠ|	𒀣	sux
gicmac	|AL×GIŠ|	𒀣	sux
jecmac	|AL×GIŠ|	𒀣	sux
hibira	|AL×HA|	𒀤	sux
dubal	|AL×KAD₃|	𒀥	sux
bal4	|AL×KI|	𒀦	sux
dubal2	|AL×KI|	𒀦	sux
il6	|AL×ŠE|	𒀧	sux
hibis2	|AL×UŠ|	𒀨	sux
hibiz2	|AL×UŠ|	𒀨	sux
cucbar	|AL×UŠ|	𒀨	sux
cucmac	|AL×UŠ|	𒀨	sux
LAK138	ALAN	𒀩	sux
al2	ALAN	𒀩	sux
alag	ALAN	𒀩	sux
alaj	ALAN	𒀩	sux
alala	ALAN	𒀩	sux
alam	ALAN	𒀩	sux
alan	ALAN	𒀩	sux
belili	ALAN	𒀩	sux
biceba2	ALAN	𒀩	sux
bicebi2	ALAN	𒀩	sux
kacceba2	ALAN	𒀩	sux
kaccebi2	ALAN	𒀩	sux
LAK267	AMAR	𒀫	sux
amar	AMAR	𒀫	sux
mar2	AMAR	𒀫	sux
mara2	AMAR	𒀫	sux
marad	AMAR	𒀫	sux
surx	AMAR	𒀫	sux
s,ar2	AMAR	𒀫	sux
s,ur	AMAR	𒀫	sux
s,uru	AMAR	𒀫	sux
zur	AMAR	𒀫	sux
marad2	|AMAR.DA|	𒀫𒁕	sux
marduk	|AMAR.UD|	𒀫𒌓	sux
LAK268	|AMAR×ŠE|	𒀬	sux
disgur	|AMAR×ŠE|	𒀬	sux
siskur	|AMAR×ŠE|	𒀬	sux
sickur	|AMAR×ŠE|	𒀬	sux
sizkur	|AMAR×ŠE|	𒀬	sux
siskur2	|AMAR×ŠE.AMAR×ŠE|	𒀬𒀬	sux
sickur2	|AMAR×ŠE.AMAR×ŠE|	𒀬𒀬	sux
sizkur2	|AMAR×ŠE.AMAR×ŠE|	𒀬𒀬	sux
LAK8	AN	𒀭	sux
MZL10	AN	𒀭	sux
a11	AN	𒀭	sux
am6	AN	𒀭	sux
an	AN	𒀭	sux
ana2	AN	𒀭	sux
anu	AN	𒀭	sux
d	AN	𒀭	sux
dalhamunx	AN	𒀭	sux
der	AN	𒀭	sux
dibur	AN	𒀭	sux
digir	AN	𒀭	sux
dijir	AN	𒀭	sux
dimer	AN	𒀭	sux
/dimer/	AN	𒀭	sux
dimir	AN	𒀭	sux
dimmer	AN	𒀭	sux
diner	AN	𒀭	sux
dingir	AN	𒀭	sux
dingira	AN	𒀭	sux
dinir	AN	𒀭	sux
dir3	AN	𒀭	sux
el3	AN	𒀭	sux
eccu2	AN	𒀭	sux
il3	AN	𒀭	sux
ila	AN	𒀭	sux
ili	AN	𒀭	sux
ilu	AN	𒀭	sux
le4	AN	𒀭	sux
sa8	AN	𒀭	sux
cubul	AN	𒀭	sux
s,a3	AN	𒀭	sux
usanx	AN	𒀭	sux
za5	AN	𒀭	sux
ita4	|AN.A.LAGAB×HAL|	𒀭𒀀𒇉	sux
iti4	|AN.A.LAGAB×HAL|	𒀭𒀀𒇉	sux
itu4	|AN.A.LAGAB×HAL|	𒀭𒀀𒇉	sux
abx	|AN.AN|	𒀭𒀭	sux
nab3	|AN.AN|	𒀭𒀭	sux
namx	|AN.AN|	𒀭𒀭	sux
cuhubx	|AN.	𒀭𒀯	sux
tilla4	|AN.AŠ.A.AN|	𒀭𒀸𒀀𒀭	sux
barzil	|AN.AŠ.AN|	𒀭𒀸𒀭	sux
tilla2	|AN.AŠ.AN|	𒀭𒀸𒀭	sux
tilla5	|AN.AŠ@z.AN|	𒀭𒀹𒀭	sux
kunigara	|AN.BARA₂|	𒀭𒁈	sux
tilla3	|AN.DIŠ.AN|	𒀭𒁹𒀭	sux
accan	|AN.DU.AN|	𒀭𒁺𒀭	sux
usanx	|AN.GU₂×KAK|	𒀭𒄙	sux
usanx	|AN.GU₂×NUN|	𒀭𒄛	sux
anzux	|AN.HU.MI.IM|	𒀭𒄷𒈪𒅎	sux
gunx	|AN.HU.MI.IM|	𒀭𒄷𒈪𒅎	sux
qutrax	|AN.IM|	𒀭𒅎	sux
kutrax	|AN.IM|	𒀭𒅎	sux
anzu	|AN.IM.DUGUD|	𒀭𒅎𒂂	sux
anzud	|AN.IM.DUGUD|	𒀭𒅎𒂂	sux
anzu2	|AN.IM.MI|	𒀭𒅎𒈪	sux
anzud2	|AN.IM.MI|	𒀭𒅎𒈪	sux
ili7	|AN.ME.U.U.U|	𒀭𒈨𒌍	sux
kunigara2	|AN.MUŠ|	𒀭𒈲	sux
zabalax	|AN.MUŠ₃.AB|	𒀭𒈹𒀊	sux
zabalax	|AN.MUŠ₃.AB@g|	𒀭𒈹𒀕	sux
an-na	|AN.NA|	𒀭𒈾	sux
nagga	|AN.NA|	𒀭𒈾	sux
nanga5	|AN.NA|	𒀭𒈾	sux
niggi	|AN.NA|	𒀭𒈾	sux
niggin	|AN.NA|	𒀭𒈾	sux
nanibgal	|AN.NAGA|	𒀭𒉀	sux
ligidbax	|AN.SAL.TUG₂.IB|	𒀭𒊩𒌆𒅁	sux
s,illu	|AN.SAG@g|	𒀭𒊨	sux
s,il3	|AN.SAG@g|	𒀭𒊨	sux
nanibgal2	|AN.ŠE.NAGA|	𒀭𒊺𒉀	sux
kunigara3	|AN.TU|	𒀭𒌅	sux
uzugx	|AN.ZAG|	𒀭𒍠	sux
LAK9	|AN&AN|	𒀮	sux
nab	|AN&AN|	𒀮	sux
nap	|AN&AN|	𒀮	sux
tillax	|AN&AN|	𒀮	sux
dalhamun4	|4×(AN.NAGA)|	𒀱	sux
dalhamun5	|(AN.NAGA)@(AN.NAGA)|	𒀰	sux
nanna2	|AN.ŠEŠ.KI|	𒀭𒋀𒆠	sux
LAK253	ANŠE	𒀲	sux
ance	ANŠE	𒀲	sux
ance@d	ANŠE	𒀲	sux
anci	ANŠE	𒀲	sux
ancu	ANŠE	𒀲	sux
sumugan	ANŠE	𒀲	sux
cakan3	ANŠE	𒀲	sux
cakan4	|ANŠE.AN|	𒀲𒀭	sux
du25	|ANŠE.ARAD|	𒀲𒀴	sux
dur3	|ANŠE.ARAD|	𒀲𒀴	sux
duru3	|ANŠE.ARAD|	𒀲𒀴	sux
cagginx	|ANŠE.ARAD|	𒀲𒀴	sux
cakkan6	|ANŠE.ARAD|	𒀲𒀴	sux
dusi2	|ANŠE.IGI.EŠ₂|	𒀲𒅆𒂠	sux
dussa2	|ANŠE.IGI.EŠ₂|	𒀲𒅆𒂠	sux
dusu2	|ANŠE.IGI.EŠ₂|	𒀲𒅆𒂠	sux
sisix	|ANŠE.KUR|	𒀲𒆳	sux
sisi	|ANŠE.KUR.RA|	𒀲𒆳𒊏	sux
ancex	|ANŠE.PA|	𒀲𒉺	sux
ancux	|ANŠE.PA|	𒀲𒉺	sux
sumuganx	|ANŠE.PA|	𒀲𒉺	sux
cakanx	|ANŠE.PA|	𒀲𒉺	sux
eme6	|ANŠE.SAL|	𒀲𒊩	sux
durx	|ANŠE.UŠ|	𒀲𒍑	sux
MZL247	|3×AN|	𒀯	sux
LAK10	|3×AN|	𒀯	sux
kunga3	|3×AN|	𒀯	sux
kungi3	|3×AN|	𒀯	sux
mul	|3×AN|	𒀯	sux
mulu	|3×AN|	𒀯	sux
munx	|3×AN|	𒀯	sux
nap2	|3×AN|	𒀯	sux
suhub2	|3×AN|	𒀯	sux
cuhub2	|3×AN|	𒀯	sux
cun2	|3×AN|	𒀯	sux
LAK128	APIN	𒀳	sux
MZL90	APIN	𒀳	sux
absin3	APIN	𒀳	sux
abcin3	APIN	𒀳	sux
apin	APIN	𒀳	sux
apina	APIN	𒀳	sux
bin	APIN	𒀳	sux
engar	APIN	𒀳	sux
engara	APIN	𒀳	sux
erec4	APIN	𒀳	sux
eric4	APIN	𒀳	sux
pin	APIN	𒀳	sux
ur11	APIN	𒀳	sux
uru4	APIN	𒀳	sux
uc8	APIN	𒀳	sux
MZL18	ARAD	𒀴	sux
wardu	ARAD	𒀴	sux
arad	ARAD	𒀴	sux
arda	ARAD	𒀴	sux
er3	ARAD	𒀴	sux
erad	ARAD	𒀴	sux
eri3	ARAD	𒀴	sux
eru	ARAD	𒀴	sux
erum	ARAD	𒀴	sux
ir3	ARAD	𒀴	sux
irda	ARAD	𒀴	sux
...ki	ARAD	𒀴	sux
nintax	ARAD	𒀴	sux
nintah2	ARAD	𒀴	sux
nita2	ARAD	𒀴	sux
nitah2	ARAD	𒀴	sux
suburx	ARAD	𒀴	sux
subarrumx	ARAD	𒀴	sux
cubur2	ARAD	𒀴	sux
urda	ARAD	𒀴	sux
urdu	ARAD	𒀴	sux
war3	ARAD	𒀴	sux
galax	|ARAD.KU|	𒀴𒆪	sux
era	|ARAD.RA|	𒀴𒊏	sux
MZL19	|ARAD×KUR|	𒀵	sux
LAK59	|ARAD×KUR|	𒀵	sux
arad2	|ARAD×KUR|	𒀵	sux
er11	|ARAD×KUR|	𒀵	sux
ge24	|ARAD×KUR|	𒀵	sux
geme3	|ARAD×KUR|	𒀵	sux
gerec3	|ARAD×KUR|	𒀵	sux
giric3	|ARAD×KUR|	𒀵	sux
/jerec/	|ARAD×KUR|	𒀵	sux
ir11	|ARAD×KUR|	𒀵	sux
kirac	|ARAD×KUR|	𒀵	sux
nitax	|ARAD×KUR|	𒀵	sux
urda2	|ARAD×KUR|	𒀵	sux
urdu2	|ARAD×KUR|	𒀵	sux
LAK296	ARKAB₂	𒀶	sux
LAK297	ARKAB₂	𒀶	sux
arkab2	ARKAB₂	𒀶	sux
arkabx	|ARKAB₂.IB|	𒀶𒅁	sux
LAK1	AŠ	𒀸	sux
MZL1	AŠ	𒀸	sux
ana3	AŠ	𒀸	sux
as3	AŠ	𒀸	sux
ac	AŠ	𒀸	sux
aca	AŠ	𒀸	sux
acca	AŠ	𒀸	sux
as,3	AŠ	𒀸	sux
az3	AŠ	𒀸	sux
dal3	AŠ	𒀸	sux
del	AŠ	𒀸	sux
dele	AŠ	𒀸	sux
deli	AŠ	𒀸	sux
dec2	AŠ	𒀸	sux
dil	AŠ	𒀸	sux
dili	AŠ	𒀸	sux
dic2	AŠ	𒀸	sux
ec18	AŠ	𒀸	sux
ec20	AŠ	𒀸	sux
ge15	AŠ	𒀸	sux
gec4	AŠ	𒀸	sux
in6	AŠ	𒀸	sux
ina	AŠ	𒀸	sux
liri2	AŠ	𒀸	sux
liru2	AŠ	𒀸	sux
lirum2	AŠ	𒀸	sux
makac2	AŠ	𒀸	sux
makkac2	AŠ	𒀸	sux
ram2	AŠ	𒀸	sux
rim5	AŠ	𒀸	sux
ru3	AŠ	𒀸	sux
rum	AŠ	𒀸	sux
sagtag	AŠ	𒀸	sux
sagtak	AŠ	𒀸	sux
sajtak	AŠ	𒀸	sux
salugub	AŠ	𒀸	sux
santa	AŠ	𒀸	sux
santag	AŠ	𒀸	sux
santak	AŠ	𒀸	sux
simed	AŠ	𒀸	sux
cup2	AŠ	𒀸	sux
tal3	AŠ	𒀸	sux
tec	AŠ	𒀸	sux
til4	AŠ	𒀸	sux
til	AŠ	𒀸	sux
zux	AŠ	𒀸	sux
1(ac)	AŠ	𒀸	sux
1(ac@c)	AŠ	𒀸	sux
1(iku)	AŠ	𒀸	sux
ac@c	AŠ	𒀸	sux
iku@c	AŠ	𒀸	sux
MZL2	|AŠ.AŠ|	𒀸𒀸	sux
didli	|AŠ.AŠ|	𒀸𒀸	sux
man3	|AŠ.AŠ|	𒀸𒀸	sux
min5	|AŠ.AŠ|	𒀸𒀸	sux
MZL4	|AŠ.AŠ.AŠ|	𒀸𒀸𒀸	sux
ec6	|AŠ.AŠ.AŠ|	𒀸𒀸𒀸	sux
aski	|AŠ.HI×DIŠ.GI₄|	𒀸𒄱𒄄	sux
acgi	|AŠ.HI×DIŠ.GI₄|	𒀸𒄱𒄄	sux
MZL11	|AŠ+SUR|	𒀸𒋩	sux
ac-cur	|AŠ+SUR|	𒀸𒋩	sux
LAK191	|AŠ&AŠ&AŠ|	𒀼	sux
ec16	|AŠ&AŠ&AŠ|	𒀼	sux
cucur	|AŠ&AŠ&AŠ|	𒀼	sux
ac9	|AŠ&AŠ&AŠ.AŠ&AŠ&AŠ|	𒀼𒀼	sux
imin3	|AŠ&AŠ&AŠ.AŠ&AŠ&AŠ.AŠ|	𒀼𒀼𒀸	sux
imina3	|AŠ&AŠ&AŠ.AŠ&AŠ&AŠ.AŠ|	𒀼𒀼𒀸	sux
umun9	|AŠ&AŠ&AŠ.AŠ&AŠ&AŠ.AŠ|	𒀼𒀼𒀸	sux
ussa3	|AŠ&AŠ&AŠ.AŠ&AŠ&AŠ.TAB|	𒀼𒀼𒋰	sux
ussu3	|AŠ&AŠ&AŠ.AŠ&AŠ&AŠ.TAB|	𒀼𒀼𒋰	sux
ia9	|AŠ&AŠ&AŠ.TAB|	𒀼𒋰	sux
gacmu	|AŠ&AŠ.TUG₂&TUG₂.TUG₂&TUG₂.PAP|	𒀻	sux
limmu4	|AŠ&AŠ&AŠ.AŠ|	𒀼𒀸	sux
limu4	|AŠ&AŠ&AŠ.AŠ|	𒀼𒀸	sux
kad8	|AŠ&AŠ&AŠ%AŠ&AŠ&AŠ|	𒀽	sux
cucur2	|AŠ&AŠ&AŠ%AŠ&AŠ&AŠ|	𒀽	sux
bag4	|AŠ@k&AŠ@k&AŠ@k&AŠ@k|	𒍧	sux
sumx	|AŠ@k&AŠ@k&AŠ@k&AŠ@k|	𒍧	sux
bag3	BAG₃	𒁂	sux
bak3	BAG₃	𒁂	sux
MZL575	AŠ@z	𒀹	sux
1(ac@t)	AŠ@z	𒀹	sux
1(ac@t@c)	AŠ@z	𒀹	sux
ac@t	AŠ@z	𒀹	sux
ac11	AŠ@z	𒀹	sux
dec5	AŠ@z	𒀹	sux
del4	AŠ@z	𒀹	sux
dele4	AŠ@z	𒀹	sux
dil4	AŠ@z	𒀹	sux
dili4	AŠ@z	𒀹	sux
ec18	AŠ@z	𒀹	sux
ge23	AŠ@z	𒀹	sux
ic8	AŠ@z	𒀹	sux
sagtag3	AŠ@z	𒀹	sux
sagtak3	AŠ@z	𒀹	sux
sajtak3	AŠ@z	𒀹	sux
santa3	AŠ@z	𒀹	sux
santag3	AŠ@z	𒀹	sux
santak3	AŠ@z	𒀹	sux
ubu	AŠ@z	𒀹	sux
upux	AŠ@z	𒀹	sux
uzaglal	AŠ@z	𒀹	sux
1/2(iku)	AŠ@z	𒀹	sux
ilimmu	ILIMMU	𒑆	sux
9(dic)	ILIMMU	𒑆	sux
9(dic@c)	ILIMMU	𒑆	sux
kad6	|AŠ@z&AŠ@z&AŠ@z&AŠ@z|	𒍦	sux
sib3	|AŠ@z&AŠ@z&AŠ@z&AŠ@z|	𒍦	sux
sip3	|AŠ@z&AŠ@z&AŠ@z&AŠ@z|	𒍦	sux
sum5	|AŠ@z&AŠ@z&AŠ@z&AŠ@z|	𒍦	sux
cib4	|AŠ@z&AŠ@z&AŠ@z&AŠ@z|	𒍦	sux
s,ib	|AŠ@z&AŠ@z&AŠ@z&AŠ@z|	𒍦	sux
s,ibi	|AŠ@z&AŠ@z&AŠ@z&AŠ@z|	𒍦	sux
s,ip	|AŠ@z&AŠ@z&AŠ@z&AŠ@z|	𒍦	sux
zeb	|AŠ@z&AŠ@z&AŠ@z&AŠ@z|	𒍦	sux
zib	|AŠ@z&AŠ@z&AŠ@z&AŠ@z|	𒍦	sux
zip	|AŠ@z&AŠ@z&AŠ@z&AŠ@z|	𒍦	sux
zub2	|AŠ@z&AŠ@z&AŠ@z&AŠ@z|	𒍦	sux
LAK162a	AŠ₂	𒀾	sux
as2	AŠ₂	𒀾	sux
asa2	AŠ₂	𒀾	sux
aś	AŠ₂	𒀾	sux
ac2	AŠ₂	𒀾	sux
aca2	AŠ₂	𒀾	sux
as,2	AŠ₂	𒀾	sux
az2	AŠ₂	𒀾	sux
baec	AŠ₂	𒀾	sux
banec	AŠ₂	𒀾	sux
dac3	AŠ₂	𒀾	sux
deccu	AŠ₂	𒀾	sux
tac3	AŠ₂	𒀾	sux
ud2	AŠ₂	𒀾	sux
udeccu	AŠ₂	𒀾	sux
ut2	AŠ₂	𒀾	sux
utu5	AŠ₂	𒀾	sux
imjajax	|ZIZ₂.A|	𒀾𒀀	sux
imgagax	|ZIZ₂.A|	𒀾𒀀	sux
udrax	|ZIZ₂.A|	𒀾𒀀	sux
ud2-duru5	|ZIZ₂.A|	𒀾𒀀	sux
imgaga	|ZIZ₂.A.AN|	𒀾𒀀𒀭	sux
imjaja	|ZIZ₂.A.AN|	𒀾𒀀𒀭	sux
kiraci	|ZIZ₂.A.AN|	𒀾𒀀𒀭	sux
lahra	|ZIZ₂.A.AN|	𒀾𒀀𒀭	sux
udra	|ZIZ₂.A.AN|	𒀾𒀀𒀭	sux
udru	|ZIZ₂.A.AN|	𒀾𒀀𒀭	sux
ulucin	|ZIZ₂.A.AN|	𒀾𒀀𒀭	sux
imgaga3	|ZIZ₂.AN|	𒀾𒀭	sux
imjaja3	|ZIZ₂.AN|	𒀾𒀭	sux
kiracix	|ZIZ₂.AN|	𒀾𒀭	sux
udra3	|ZIZ₂.AN|	𒀾𒀭	sux
ulucin3	|ZIZ₂.AN|	𒀾𒀭	sux
imgaga2	|ZIZ₂.AN.NA|	𒀾𒀭𒈾	sux
imjaja2	|ZIZ₂.AN.NA|	𒀾𒀭𒈾	sux
kiracix	|ZIZ₂.AN.NA|	𒀾𒀭𒈾	sux
udra2	|ZIZ₂.AN.NA|	𒀾𒀭𒈾	sux
ulucin2	|ZIZ₂.AN.NA|	𒀾𒀭𒈾	sux
LAK779?	|AŠ₂.GAR₃|	𒀾𒃼	sux
ecgar	|AŠ₂.GAR₃|	𒀾𒃼	sux
banlimmu	|AŠ₂.U|	𒀾𒌋	sux
LAK346?	AŠGAB	𒀿	sux
acgab	AŠGAB	𒀿	sux
erib	AŠGAB	𒀿	sux
irib	AŠGAB	𒀿	sux
cigagu	AŠGAB	𒀿	sux
cikangu	AŠGAB	𒀿	sux
LAK290	BA	𒁀	sux
MZL14	BA	𒁀	sux
ba	BA	𒁀	sux
be4	BA	𒁀	sux
bi6	BA	𒁀	sux
libit	BA	𒁀	sux
pa2	BA	𒁀	sux
wa2	BA	𒁀	sux
LAK16	BAD	𒁁	sux
MZL113	BAD	𒁁	sux
ba9	BAD	𒁁	sux
bad	BAD	𒁁	sux
bada	BAD	𒁁	sux
bara4	BAD	𒁁	sux
bat	BAD	𒁁	sux
bata	BAD	𒁁	sux
bat	BAD	𒁁	sux
be	BAD	𒁁	sux
bi4	BAD	𒁁	sux
bid2	BAD	𒁁	sux
bit2	BAD	𒁁	sux
dihi	BAD	𒁁	sux
dim7	BAD	𒁁	sux
edim	BAD	𒁁	sux
ec7	BAD	𒁁	sux
idin	BAD	𒁁	sux
mat2	BAD	𒁁	sux
me4	BAD	𒁁	sux
med	BAD	𒁁	sux
met	BAD	𒁁	sux
met	BAD	𒁁	sux
mit	BAD	𒁁	sux
miti	BAD	𒁁	sux
mitu	BAD	𒁁	sux
mit	BAD	𒁁	sux
mud2	BAD	𒁁	sux
mut2	BAD	𒁁	sux
pax	BAD	𒁁	sux
pad2	BAD	𒁁	sux
pat2	BAD	𒁁	sux
pat2	BAD	𒁁	sux
pe3	BAD	𒁁	sux
pet2	BAD	𒁁	sux
pi3	BAD	𒁁	sux
pid2	BAD	𒁁	sux
pit2	BAD	𒁁	sux
qit3	BAD	𒁁	sux
sugin	BAD	𒁁	sux
sungin	BAD	𒁁	sux
s,is,	BAD	𒁁	sux
ti5	BAD	𒁁	sux
tile	BAD	𒁁	sux
til2	BAD	𒁁	sux
ulal	BAD	𒁁	sux
zar5	BAD	𒁁	sux
zara5	BAD	𒁁	sux
zaz	BAD	𒁁	sux
zis	BAD	𒁁	sux
ziz	BAD	𒁁	sux
zu4	BAD	𒁁	sux
zuru9	BAD	𒁁	sux
zar6	|BAD.AŠ|	𒁁𒀸	sux
zara6	|BAD.AŠ|	𒁁𒀸	sux
zuru10	|BAD.AŠ|	𒁁𒀸	sux
dabda2	|BAD.BAD|	𒁁𒁁	sux
burx	|BAD.IGI.BAD|	𒁁𒅆𒁁	sux
burux	|BAD.IGI.BAD|	𒁁𒅆𒁁	sux
gurinx	|BAD.IGI.BAD|	𒁁𒅆𒁁	sux
gurun2	|BAD.IGI.BAD|	𒁁𒅆𒁁	sux
kurunx	|BAD.IGI.BAD|	𒁁𒅆𒁁	sux
sagmac	|BAD.KASKAL|	𒁁𒆜	sux
sajmac	|BAD.KASKAL|	𒁁𒆜	sux
zanbur	|BAD.KASKAL|	𒁁𒆜	sux
adx	|BAD.LU₂|	𒁁𒇽	sux
adama	|BAD.MI|	𒁁𒈪	sux
adamu	|BAD.MI|	𒁁𒈪	sux
mudgi	|BAD.MI|	𒁁𒈪	sux
lugud	|BAD.UD|	𒁁𒌓	sux
agac	|BAD.X|	𒁁░░	sux
LAK742	BAHAR₂	𒁃	sux
/allura/	BAHAR₂	𒁃	sux
alurx	BAHAR₂	𒁃	sux
bahar2	BAHAR₂	𒁃	sux
lil7	BAHAR₂	𒁃	sux
lillu	BAHAR₂	𒁃	sux
muctaptin	BAHAR₂	𒁃	sux
nunurra	BAHAR₂	𒁃	sux
nunurru	BAHAR₂	𒁃	sux
LAK19	BAL	𒁄	sux
MZL5	BAL	𒁄	sux
bal	BAL	𒁄	sux
bala	BAL	𒁄	sux
balak	BAL	𒁄	sux
bul3	BAL	𒁄	sux
kulx	BAL	𒁄	sux
pal	BAL	𒁄	sux
pala4	BAL	𒁄	sux
pul3	BAL	𒁄	sux
minbulugx	|BAL&BAL|	𒁅	sux
LAK41	BALAG	𒁆	sux
balag	BALAG	𒁆	sux
balaj	BALAG	𒁆	sux
bulug5	BALAG	𒁆	sux
buluj5	BALAG	𒁆	sux
bulunx	BALAG	𒁆	sux
bum2	BALAG	𒁆	sux
gud10	BALAG	𒁆	sux
gudu10	BALAG	𒁆	sux
lumha	BALAG	𒁆	sux
takax	BALAG	𒁆	sux
hurinx	|BALAG.A|	𒁆𒀀	sux
tegi	|BALAG.LUL|	𒁆𒈜	sux
tigi	|BALAG.LUL|	𒁆𒈜	sux
tigu	|BALAG.LUL|	𒁆𒈜	sux
zabitum	|BALAG.TUR|	𒁆𒌉	sux
LAK752	BAR	𒁇	sux
MZL121	BAR	𒁇	sux
ba15	BAR	𒁇	sux
bar	BAR	𒁇	sux
bara	BAR	𒁇	sux
bare	BAR	𒁇	sux
par2	BAR	𒁇	sux
para2	BAR	𒁇	sux
sutu	BAR	𒁇	sux
war	BAR	𒁇	sux
MZL122	|BAR.AN|	𒁇𒀭	sux
kunga2	|BAR.AN|	𒁇𒀭	sux
kungi2	|BAR.AN|	𒁇𒀭	sux
LAK356~b	|ŠU₂.AN|	𒋙𒀭	sux
MZL870~b	|ŠU₂.AN|	𒋙𒀭	sux
MZL872~c	|ŠU₂.	𒋙𒀯	sux
kunga~c	|ŠU₂.	𒋙𒀯	sux
kungi~c	|ŠU₂.	𒋙𒀯	sux
MZL247~d	|3×AN|	𒀯	sux
kunga3~d	|3×AN|	𒀯	sux
kungi3~d	|3×AN|	𒀯	sux
bahar4	|BAR.EDIN|	𒁇𒂔	sux
nunmeli	|BAR.HU.KAK|	𒁇𒄷𒆕	sux
LAK153	BARA₂	𒁈	sux
bar2	BARA₂	𒁈	sux
bara2	BARA₂	𒁈	sux
barag	BARA₂	𒁈	sux
par6	BARA₂	𒁈	sux
para10	BARA₂	𒁈	sux
parag	BARA₂	𒁈	sux
ca23	BARA₂	𒁈	sux
car6	BARA₂	𒁈	sux
cara	BARA₂	𒁈	sux
LAK639	BI	𒁉	sux
MZL358	BI	𒁉	sux
be2	BI	𒁉	sux
bi	BI	𒁉	sux
biz	BI	𒁉	sux
dugx	BI	𒁉	sux
ebirx	BI	𒁉	sux
epir2	BI	𒁉	sux
ecemen5	BI	𒁉	sux
ecemin5	BI	𒁉	sux
gac	BI	𒁉	sux
huburx	BI	𒁉	sux
ka8	BI	𒁉	sux
kas2	BI	𒁉	sux
kac	BI	𒁉	sux
kas,2	BI	𒁉	sux
pe2	BI	𒁉	sux
pi2	BI	𒁉	sux
sa18	BI	𒁉	sux
siris4	BI	𒁉	sux
su15	BI	𒁉	sux
ca21	BI	𒁉	sux
cu13	BI	𒁉	sux
kac-bir8	|BI.A.SUD|	𒁉𒀀𒋤	sux
kacbir	|BI.A.SUD|	𒁉𒀀𒋤	sux
ulucinx	|BI.A.SUD|	𒁉𒀀𒋤	sux
{kac}ulucinx	|BI.ZIZ₂|	𒁉𒀾	sux
{kac}ulucin	|BI.ZIZ₂.A.AN|	𒁉𒀾𒀀𒀭	sux
{kac}ulucin3	|BI.ZIZ₂.AN|	𒁉𒀾𒀭	sux
{kac}ulucin2	|BI.ZIZ₂.AN.NA|	𒁉𒀾𒀭𒈾	sux
lungax	|BI.DAR|	𒁉𒁯	sux
kurun	|BI.DIN|	𒁉𒁷	sux
kucum	|BI.LUL|	𒁉𒈜	sux
caqa	|BI.LUL|	𒁉𒈜	sux
caqu	|BI.LUL|	𒁉𒈜	sux
caqum	|BI.LUL|	𒁉𒈜	sux
kurun5	|BI.MI|	𒁉𒈪	sux
siris5	|BI.MI|	𒁉𒈪	sux
dida	|BI.U₂.SA|	𒁉𒌑𒊓	sux
kacdida	|BI.U₂.SA|	𒁉𒌑𒊓	sux
kacpihu4	|BI.U₂.SA|	𒁉𒌑𒊓	sux
kacpihu	|BI.U₂.SA|	𒁉𒌑𒊓	sux
kacdida2	|BI.UŠ.SA|	𒁉𒍑𒊓	sux
kacpihu3	|BI.UŠ.SA|	𒁉𒍑𒊓	sux
LAK642	|BI×A|	𒁊	sux
LAK641	|BI×GAR|	𒁋	sux
bappir3	|BI×GAR|	𒁋	sux
bappira3	|BI×GAR|	𒁋	sux
lungax	|BI×GAR|	𒁋	sux
LAK640	|BI×IGI@g|	𒁌	sux
cembi3	|BI×IGI@g|	𒁌	sux
cimbi3	|BI×IGI@g|	𒁌	sux
LAK232	BU	𒁍	sux
bu	BU	𒁍	sux
bur12	BU	𒁍	sux
dim13	BU	𒁍	sux
dul10	BU	𒁍	sux
dur7	BU	𒁍	sux
gazibu	BU	𒁍	sux
gazimbi	BU	𒁍	sux
gazinbi	BU	𒁍	sux
gazinbu	BU	𒁍	sux
gi27	BU	𒁍	sux
gid2	BU	𒁍	sux
gida2	BU	𒁍	sux
gidi3	BU	𒁍	sux
gidim3	BU	𒁍	sux
gim7	BU	𒁍	sux
git2	BU	𒁍	sux
git2	BU	𒁍	sux
guz2	BU	𒁍	sux
ildumx	BU	𒁍	sux
kid10	BU	𒁍	sux
kim3	BU	𒁍	sux
kit10	BU	𒁍	sux
madal	BU	𒁍	sux
madla	BU	𒁍	sux
madlu	BU	𒁍	sux
malla	BU	𒁍	sux
mudla	BU	𒁍	sux
mudlu	BU	𒁍	sux
mudra3	BU	𒁍	sux
mudru3	BU	𒁍	sux
mudul	BU	𒁍	sux
mulla	BU	𒁍	sux
mullu	BU	𒁍	sux
nun3	BU	𒁍	sux
pi8	BU	𒁍	sux
pu	BU	𒁍	sux
qid2	BU	𒁍	sux
qit2	BU	𒁍	sux
ra5	BU	𒁍	sux
ser2	BU	𒁍	sux
six	BU	𒁍	sux
sir2	BU	𒁍	sux
su13	BU	𒁍	sux
sud4	BU	𒁍	sux
sugx	BU	𒁍	sux
surx	BU	𒁍	sux
suc3	BU	𒁍	sux
cacki	BU	𒁍	sux
cacku	BU	𒁍	sux
cer2	BU	𒁍	sux
cir2	BU	𒁍	sux
cud2	BU	𒁍	sux
tur8	BU	𒁍	sux
sirsir	|BU&BU.AB|	𒁎	sux
gutir	|BU&BU.UN|	𒁏	sux
kide	|BU&BU.UN|	𒁏	sux
unu12	|BU%BU|	𒁐	sux
bu9	BULUG	𒁑	sux
bulug	BULUG	𒁑	sux
buluj	BULUG	𒁑	sux
magar	BULUG	𒁑	sux
magara	BULUG	𒁑	sux
mangara	BULUG	𒁑	sux
muc6	BULUG	𒁑	sux
nagarx	BULUG	𒁑	sux
nijinx	BULUG	𒁑	sux
minbulugx	|BULUG.NAGAR|	𒁑𒉄	sux
mebulug2	|BULUG&BULUG|	𒁒	sux
menbulug2	|BULUG&BULUG|	𒁒	sux
minbulug2	|BULUG&BULUG|	𒁒	sux
cembulug	|BULUG&BULUG|	𒁒	sux
cimbulug	|BULUG&BULUG|	𒁒	sux
LAK169	BUR	𒁓	sux
bur	BUR	𒁓	sux
buru	BUR	𒁓	sux
limx	BUR	𒁓	sux
pur	BUR	𒁓	sux
puru	BUR	𒁓	sux
LAK52	BUR₂	𒁔	sux
MZL8	BUR₂	𒁔	sux
bal2	BUR₂	𒁔	sux
bu8	BUR₂	𒁔	sux
bul2	BUR₂	𒁔	sux
bulug2	BUR₂	𒁔	sux
bur2	BUR₂	𒁔	sux
buru2	BUR₂	𒁔	sux
du9	BUR₂	𒁔	sux
dun5	BUR₂	𒁔	sux
pul2	BUR₂	𒁔	sux
su16	BUR₂	𒁔	sux
sun5	BUR₂	𒁔	sux
cum5	BUR₂	𒁔	sux
ucu	BUR₂	𒁔	sux
ucum	BUR₂	𒁔	sux
bubbur	|BUR₂.BUR₂|	𒁔𒁔	sux
buru5~c	NAM@n	𒉅	sux
LAK143	DA	𒁕	sux
ax	DA	𒁕	sux
da	DA	𒁕	sux
dix	DA	𒁕	sux
du20	DA	𒁕	sux
idi3	DA	𒁕	sux
le10	DA	𒁕	sux
li10	DA	𒁕	sux
qab3	DA	𒁕	sux
ta2	DA	𒁕	sux
ta	DA	𒁕	sux
gabrax	|DA.UŠ|	𒁕𒍑	sux
ragabx	|DA.UŠ|	𒁕𒍑	sux
LAK740	DAG	𒁖	sux
bar3	DAG	𒁖	sux
bara3	DAG	𒁖	sux
barag2	DAG	𒁖	sux
da8	DAG	𒁖	sux
dag	DAG	𒁖	sux
dak	DAG	𒁖	sux
daq	DAG	𒁖	sux
par3	DAG	𒁖	sux
para3	DAG	𒁖	sux
tag2	DAG	𒁖	sux
tak2	DAG	𒁖	sux
taq2	DAG	𒁖	sux
tak	DAG	𒁖	sux
cihumx	|DAG.KISIM₅|	𒁖𒆨	sux
massa2	|DAG.KISIM₅×(A.MAŠ)|	𒁗	sux
garim2	|DAG.KISIM₅×AMAR|	𒁘	sux
jarim2	|DAG.KISIM₅×AMAR|	𒁘	sux
caran	|DAG.KISIM₅×BALAG|	𒁙	sux
harx	|DAG.KISIM₅×BI|	𒁚	sux
hara4	|DAG.KISIM₅×BI|	𒁚	sux
haru4	|DAG.KISIM₅×BI|	𒁚	sux
LAK744	|DAG.KISIM₅×GA|	𒁜	sux
akan	|DAG.KISIM₅×GA|	𒁜	sux
akani	|DAG.KISIM₅×GA|	𒁜	sux
harax	|DAG.KISIM₅×GA|	𒁜	sux
kisim7	|DAG.KISIM₅×GA|	𒁜	sux
subx	|DAG.KISIM₅×GA|	𒁜	sux
ubur	|DAG.KISIM₅×GA|	𒁜	sux
massa	|DAG.KISIM₅×(GA.MAŠ)|	𒁜	sux
kec7	|DAG.KISIM₅×GI|	𒁝	sux
kici7	|DAG.KISIM₅×GI|	𒁝	sux
kec8	|DAG.KISIM₅×GIR₂|	𒁞	sux
kirim	|DAG.KISIM₅×GIR₂|	𒁞	sux
kisix	|DAG.KISIM₅×GIR₂|	𒁞	sux
kisim4	|DAG.KISIM₅×GIR₂|	𒁞	sux
kici8	|DAG.KISIM₅×GIR₂|	𒁞	sux
udul5	|DAG.KISIM₅×GUD|	𒁟	sux
utul5	|DAG.KISIM₅×GUD|	𒁟	sux
hulum3	|DAG.KISIM₅×HA|	𒁠	sux
hunin	|DAG.KISIM₅×HA|	𒁠	sux
ubur3	|DAG.KISIM₅×IR|	𒁡	sux
ubur4	|DAG.KISIM₅×(IR.LU)|	𒁢	sux
gabar2	|DAG.KISIM₅×KAK|	𒁣	sux
kabar2	|DAG.KISIM₅×KAK|	𒁣	sux
pax	|DAG.KISIM₅×KAK|	𒁣	sux
lahta6	|DAG.KISIM₅×LA|	𒁤	sux
lahtan6	|DAG.KISIM₅×LA|	𒁤	sux
LAK721	|DAG.KISIM₅×LU|	𒁥	sux
kisimx	|DAG.KISIM₅×LU|	𒁥	sux
ubur2	|DAG.KISIM₅×LU|	𒁥	sux
amac	|DAG.KISIM₅×(LU.MAŠ₂)|	𒁦	sux
amaca	|DAG.KISIM₅×(LU.MAŠ₂)|	𒁦	sux
harax	|DAG.KISIM₅×(LU.MAŠ₂)|	𒁦	sux
kisim3	|DAG.KISIM₅×(LU.MAŠ₂)|	𒁦	sux
ua4	|DAG.KISIM₅×(LU.MAŠ₂)|	𒁦	sux
udul3	|DAG.KISIM₅×(LU.MAŠ₂)|	𒁦	sux
utua2	|DAG.KISIM₅×(LU.MAŠ₂)|	𒁦	sux
utul3	|DAG.KISIM₅×(LU.MAŠ₂)|	𒁦	sux
utuwa2	|DAG.KISIM₅×(LU.MAŠ₂)|	𒁦	sux
hulum	|DAG.KISIM₅×LUM|	𒁧	sux
ge28	|DAG.KISIM₅×NE|	𒁨	sux
curin4	|DAG.KISIM₅×NE|	𒁨	sux
curun4	|DAG.KISIM₅×NE|	𒁨	sux
rapiku	|DAG.KISIM₅×(PAP.PAP)|	𒁩	sux
rapiqu	|DAG.KISIM₅×(PAP.PAP)|	𒁩	sux
kisim2	|DAG.KISIM₅×SI|	𒁪	sux
zibin	|DAG.KISIM₅×TAK₄|	𒁫	sux
hara5	|DAG.KISIM₅×(U₂.GIR₂)|	𒁬	sux
harub	|DAG.KISIM₅×(U₂.GIR₂)|	𒁬	sux
kec9	|DAG.KISIM₅×(U₂.GIR₂)|	𒁬	sux
kisim	|DAG.KISIM₅×(U₂.GIR₂)|	𒁬	sux
kici9	|DAG.KISIM₅×(U₂.GIR₂)|	𒁬	sux
caran2	|DAG.KISIM₅×(U₂.GIR₂)|	𒁬	sux
carin	|DAG.KISIM₅×(U₂.GIR₂)|	𒁬	sux
curin5	|DAG.KISIM₅×(U₂.GIR₂)|	𒁬	sux
curun5	|DAG.KISIM₅×(U₂.GIR₂)|	𒁬	sux
zibin2	|DAG.KISIM₅×(U₂.GIR₂)|	𒁬	sux
LAK777	|DAG.KISIM₅×UŠ|	𒁭	sux
udul6	|DAG.KISIM₅×UŠ|	𒁭	sux
utua	|DAG.KISIM₅×UŠ|	𒁭	sux
utul6	|DAG.KISIM₅×UŠ|	𒁭	sux
utuwa	|DAG.KISIM₅×UŠ|	𒁭	sux
ku12	|DAG.KISIM₅×X|	𒁖	sux
lu10	|DAG.KISIM₅×X|	𒁖	sux
LAK523	DAM	𒁮	sux
da4	DAM	𒁮	sux
dam	DAM	𒁮	sux
dama	DAM	𒁮	sux
dum3	DAM	𒁮	sux
lam3	DAM	𒁮	sux
ta4	DAM	𒁮	sux
tam2	DAM	𒁮	sux
tum10	DAM	𒁮	sux
ta4	DAM	𒁮	sux
tam	DAM	𒁮	sux
dax	DAR	𒁯	sux
dar	DAR	𒁯	sux
dac4	DAR	𒁯	sux
dir2	DAR	𒁯	sux
gux	DAR	𒁯	sux
gun3	DAR	𒁯	sux
gunu3	DAR	𒁯	sux
tar2	DAR	𒁯	sux
tir3	DAR	𒁯	sux
tar2	DAR	𒁯	sux
tir4	DAR	𒁯	sux
LAK264	DARA₃	𒁰	sux
dar3	DARA₃	𒁰	sux
dara3	DARA₃	𒁰	sux
durah	DARA₃	𒁰	sux
tar3	DARA₃	𒁰	sux
tara3	DARA₃	𒁰	sux
tarah	DARA₃	𒁰	sux
tar3	DARA₃	𒁰	sux
LAK670	DARA₄	𒁱	sux
MZL817	DARA₄	𒁱	sux
dar4	DARA₄	𒁱	sux
dara4	DARA₄	𒁱	sux
durahx	DARA₄	𒁱	sux
gana6	DARA₄	𒁱	sux
ganam6	DARA₄	𒁱	sux
inna	DARA₄	𒁱	sux
lahar2	DARA₄	𒁱	sux
lahrum2	DARA₄	𒁱	sux
mudru4	DARA₄	𒁱	sux
nina2	DARA₄	𒁱	sux
ninnax	DARA₄	𒁱	sux
tarahx	DARA₄	𒁱	sux
ua2	DARA₄	𒁱	sux
u10	DARA₄	𒁱	sux
LAK439	DI	𒁲	sux
MZL736	DI	𒁲	sux
de	DI	𒁲	sux
di	DI	𒁲	sux
dux	DI	𒁲	sux
sa2	DI	𒁲	sux
sal2	DI	𒁲	sux
salagud	DI	𒁲	sux
salgud	DI	𒁲	sux
salim	DI	𒁲	sux
se8	DI	𒁲	sux
si8	DI	𒁲	sux
silix	DI	𒁲	sux
silim	DI	𒁲	sux
silima	DI	𒁲	sux
sim3	DI	𒁲	sux
sisax	DI	𒁲	sux
śa2	DI	𒁲	sux
ca18	DI	𒁲	sux
cul3	DI	𒁲	sux
te10	DI	𒁲	sux
ti4	DI	𒁲	sux
te	DI	𒁲	sux
ti	DI	𒁲	sux
sadu	|DI.DI|	𒁲𒁲	sux
guructix	|DI.X|	𒁲░░	sux
MZL813	DIB	𒁳	sux
dab	DIB	𒁳	sux
daba	DIB	𒁳	sux
dabe	DIB	𒁳	sux
dap	DIB	𒁳	sux
deb	DIB	𒁳	sux
dix	DIB	𒁳	sux
dib	DIB	𒁳	sux
dibi	DIB	𒁳	sux
dip	DIB	𒁳	sux
dubba	DIB	𒁳	sux
dul8	DIB	𒁳	sux
nu12	DIB	𒁳	sux
teb	DIB	𒁳	sux
tep	DIB	𒁳	sux
tib	DIB	𒁳	sux
tip	DIB	𒁳	sux
tab3	DIB	𒁳	sux
tap3	DIB	𒁳	sux
teb	DIB	𒁳	sux
tep	DIB	𒁳	sux
tib	DIB	𒁳	sux
tip	DIB	𒁳	sux
LAK53	DIM	𒁴	sux
di11	DIM	𒁴	sux
dim	DIM	𒁴	sux
dum4	DIM	𒁴	sux
mun3	DIM	𒁴	sux
tam3	DIM	𒁴	sux
tem	DIM	𒁴	sux
ti3	DIM	𒁴	sux
tim	DIM	𒁴	sux
tum8	DIM	𒁴	sux
tem	DIM	𒁴	sux
tim	DIM	𒁴	sux
MZL168	|DIM×ŠE|	𒁵	sux
gakkul2	|DIM×ŠE|	𒁵	sux
kakkul2	|DIM×ŠE|	𒁵	sux
mun	|DIM×ŠE|	𒁵	sux
munu	|DIM×ŠE|	𒁵	sux
LAK481	DIM₂	𒁶	sux
dem2	DIM₂	𒁶	sux
dix	DIM₂	𒁶	sux
dim2	DIM₂	𒁶	sux
dima2	DIM₂	𒁶	sux
ge18	DIM₂	𒁶	sux
gem	DIM₂	𒁶	sux
gen7	DIM₂	𒁶	sux
gi18	DIM₂	𒁶	sux
gim	DIM₂	𒁶	sux
gimi	DIM₂	𒁶	sux
gin7	DIM₂	𒁶	sux
ke5	DIM₂	𒁶	sux
ki5	DIM₂	𒁶	sux
kim	DIM₂	𒁶	sux
kin8	DIM₂	𒁶	sux
mucda	DIM₂	𒁶	sux
mucdam	DIM₂	𒁶	sux
mucdama	DIM₂	𒁶	sux
qim	DIM₂	𒁶	sux
cidi	DIM₂	𒁶	sux
cidim	DIM₂	𒁶	sux
cilamx	DIM₂	𒁶	sux
citim	DIM₂	𒁶	sux
citalamx	DIM₂	𒁶	sux
/citlam/	DIM₂	𒁶	sux
tam6	DIM₂	𒁶	sux
tem2	DIM₂	𒁶	sux
tim2	DIM₂	𒁶	sux
LAK237	DIN	𒁷	sux
MZL119	DIN	𒁷	sux
dan5	DIN	𒁷	sux
den	DIN	𒁷	sux
di2	DIN	𒁷	sux
din	DIN	𒁷	sux
dini	DIN	𒁷	sux
gurun8	DIN	𒁷	sux
idinx	DIN	𒁷	sux
kurun2	DIN	𒁷	sux
ten2	DIN	𒁷	sux
ti2	DIN	𒁷	sux
tilx	DIN	𒁷	sux
tim3	DIN	𒁷	sux
tin	DIN	𒁷	sux
tin	DIN	𒁷	sux
sagkurun	|DIN.KASKAL.U@g.DIŠ|	𒁸	sux
babilax	|DIN.ŠE.NUN&NUN|	𒁷𒊺𒉪	sux
din-tir	|DIN.ŠE.NUN&NUN|	𒁷𒊺𒉪	sux
gamun	|DIN.ŠE.NUN&NUN|	𒁷𒊺𒉪	sux
MZL748	DIŠ	𒁹	sux
anx	DIŠ	𒁹	sux
ana	DIŠ	𒁹	sux
ac10	DIŠ	𒁹	sux
dac2	DIŠ	𒁹	sux
dec	DIŠ	𒁹	sux
dic	DIŠ	𒁹	sux
dica	DIŠ	𒁹	sux
duc2	DIŠ	𒁹	sux
gala10	DIŠ	𒁹	sux
ge3	DIŠ	𒁹	sux
gec2	DIŠ	𒁹	sux
gecta	DIŠ	𒁹	sux
gi3	DIŠ	𒁹	sux
gic2	DIŠ	𒁹	sux
jec2	DIŠ	𒁹	sux
jic2	DIŠ	𒁹	sux
il4	DIŠ	𒁹	sux
ili6	DIŠ	𒁹	sux
ec4	DIŠ	𒁹	sux
ic4	DIŠ	𒁹	sux
m	DIŠ	𒁹	sux
makac	DIŠ	𒁹	sux
makkac	DIŠ	𒁹	sux
muc7	DIŠ	𒁹	sux
nigida	DIŠ	𒁹	sux
sajtak4	DIŠ	𒁹	sux
salubug2	DIŠ	𒁹	sux
salugub2	DIŠ	𒁹	sux
sandak4	DIŠ	𒁹	sux
santa4	DIŠ	𒁹	sux
santag4	DIŠ	𒁹	sux
santak4	DIŠ	𒁹	sux
cantag	DIŠ	𒁹	sux
cantak	DIŠ	𒁹	sux
tal4	DIŠ	𒁹	sux
tac2	DIŠ	𒁹	sux
til5	DIŠ	𒁹	sux
tic	DIŠ	𒁹	sux
tiz	DIŠ	𒁹	sux
tic	DIŠ	𒁹	sux
uc9	DIŠ	𒁹	sux
1(dic)	DIŠ	𒁹	sux
1(dic@c)	DIŠ	𒁹	sux
dic@c	DIŠ	𒁹	sux
barig@c	DIŠ	𒁹	sux
1(barig)	DIŠ	𒁹	sux
1(barig@c)	DIŠ	𒁹	sux
1(bariga)	DIŠ	𒁹	sux
1(bariga@c)	DIŠ	𒁹	sux
acdarx	|DIŠ.DAR|	𒁹𒁯	sux
ux(DIc)-gun3	|DIŠ.DAR|	𒁹𒁯	sux
ec5	|DIŠ.DIŠ.DIŠ|	𒁹𒁹𒁹	sux
eca5	|DIŠ.DIŠ.DIŠ|	𒁹𒁹𒁹	sux
eccaba	|DIŠ.DIŠ.DIŠ.U.U|	𒁹𒁹𒁹𒌋𒌋	sux
eccana	|DIŠ.DIŠ.DIŠ.U.U|	𒁹𒁹𒁹𒌋𒌋	sux
iccebu	|DIŠ.DIŠ.DIŠ.U.U|	𒁹𒁹𒁹𒌋𒌋	sux
iccebux	|DIŠ.DIŠ.DIŠ.U.U.U|	𒁹𒁹𒁹𒌍	sux
LAK484	DU	𒁺	sux
ar6	DU	𒁺	sux
ara6	DU	𒁺	sux
aragub	DU	𒁺	sux
de6	DU	𒁺	sux
di6	DU	𒁺	sux
du	DU	𒁺	sux
dulx	DU	𒁺	sux
er10	DU	𒁺	sux
ge13	DU	𒁺	sux
gen	DU	𒁺	sux
gim6	DU	𒁺	sux
gin	DU	𒁺	sux
ginax	DU	𒁺	sux
gir7	DU	𒁺	sux
gub	DU	𒁺	sux
guba	DU	𒁺	sux
gubu	DU	𒁺	sux
gup	DU	𒁺	sux
jen	DU	𒁺	sux
jin	DU	𒁺	sux
jim6	DU	𒁺	sux
im6	DU	𒁺	sux
ir10	DU	𒁺	sux
kac5	DU	𒁺	sux
kim6	DU	𒁺	sux
kin7	DU	𒁺	sux
kux	DU	𒁺	sux
kub	DU	𒁺	sux
kup	DU	𒁺	sux
kurx	DU	𒁺	sux
lah6	DU	𒁺	sux
men3	DU	𒁺	sux
mix	DU	𒁺	sux
nax	DU	𒁺	sux
qub	DU	𒁺	sux
qup	DU	𒁺	sux
ra2	DU	𒁺	sux
re6	DU	𒁺	sux
ri6	DU	𒁺	sux
ca4	DU	𒁺	sux
ce13	DU	𒁺	sux
tu3	DU	𒁺	sux
tum2	DU	𒁺	sux
tuma2	DU	𒁺	sux
tumu2	DU	𒁺	sux
tu3	DU	𒁺	sux
ur8	DU	𒁺	sux
erx	|DU.DU|	𒁺𒁺	sux
gidx	|DU.DU|	𒁺𒁺	sux
lah5	|DU.DU|	𒁺𒁺	sux
laha5	|DU.DU|	𒁺𒁺	sux
lalah2	|DU.DU|	𒁺𒁺	sux
rahx	|DU.DU|	𒁺𒁺	sux
cux	|DU.DU|	𒁺𒁺	sux
lahx	|DU.DU.DU.DU|	𒁺𒁺𒁺𒁺	sux
lalahx	|DU.DU.DU.DU|	𒁺𒁺𒁺𒁺	sux
rahx	|DU.DU.DU.DU|	𒁺𒁺𒁺𒁺	sux
rex	|DU.DU.DU.DU|	𒁺𒁺𒁺𒁺	sux
sux	|DU.DU.DU.DU|	𒁺𒁺𒁺𒁺	sux
subx	|DU.DU.DU.DU|	𒁺𒁺𒁺𒁺	sux
sugx	|DU.DU.DU.DU|	𒁺𒁺𒁺𒁺	sux
cux	|DU.DU.DU.DU|	𒁺𒁺𒁺𒁺	sux
rig12	|DU.HUB₂|	𒁺𒄸	sux
rige12	|DU.HUB₂|	𒁺𒄸	sux
la4	|DU&DU|	𒁻	sux
lah4	|DU&DU|	𒁻	sux
laha4	|DU&DU|	𒁻	sux
lalah	|DU&DU|	𒁻	sux
re7	|DU&DU|	𒁻	sux
ri7	|DU&DU|	𒁻	sux
su8	|DU&DU|	𒁻	sux
sub2	|DU&DU|	𒁻	sux
sug2	|DU&DU|	𒁻	sux
sup2	|DU&DU|	𒁻	sux
lahx	|DU&DU.DU&DU|	𒁻𒁻	sux
rahx	|DU&DU.DU&DU|	𒁻𒁻	sux
rex	|DU&DU.DU&DU|	𒁻𒁻	sux
sux	|DU&DU.DU&DU|	𒁻𒁻	sux
subx	|DU&DU.DU&DU|	𒁻𒁻	sux
sugx	|DU&DU.DU&DU|	𒁻𒁻	sux
cux	|DU&DU.DU&DU|	𒁻𒁻	sux
LAK486	DU@g	𒁼	sux
icdu	DU@g	𒁼	sux
gim5	DU@g	𒁼	sux
gir6	DU@g	𒁼	sux
giri6	DU@g	𒁼	sux
im5	DU@g	𒁼	sux
icdumx	DU@g	𒁼	sux
kas5	DU@g	𒁼	sux
kim5	DU@g	𒁼	sux
suh6	DU@g	𒁼	sux
suhuc	DU@g	𒁼	sux
cuhuc	DU@g	𒁼	sux
gigri	|DU@g.DU@g|	𒁼𒁼	sux
ālik	DU@s	𒁽	sux
lāsimu	DU@s	𒁽	sux
gim4	DU@s	𒁽	sux
gir5	DU@s	𒁽	sux
giri5	DU@s	𒁽	sux
girim2	DU@s	𒁽	sux
im2	DU@s	𒁽	sux
ka7	DU@s	𒁽	sux
kaku	DU@s	𒁽	sux
kamac	DU@s	𒁽	sux
kas4	DU@s	𒁽	sux
kac4	DU@s	𒁽	sux
kim4	DU@s	𒁽	sux
lah7	DU@s	𒁽	sux
rax	DU@s	𒁽	sux
rim4	DU@s	𒁽	sux
gan3	|DU@s.A|	𒁽𒀀	sux
gana3	|DU@s.A|	𒁽𒀀	sux
gigri2	|DU@s.DU@s|	𒁽𒁽	sux
lah7	|DU@s.DU@s|	𒁽𒁽	sux
rahx	|DU@s.DU@s|	𒁽𒁽	sux
rex	|DU@s.DU@s|	𒁽𒁽	sux
sux	|DU@s.DU@s|	𒁽𒁽	sux
subx	|DU@s.DU@s|	𒁽𒁽	sux
sugx	|DU@s.DU@s|	𒁽𒁽	sux
cux	|DU@s.DU@s|	𒁽𒁽	sux
LAK609	DUB	𒁾	sux
le)um	DUB	𒁾	sux
dab4	DUB	𒁾	sux
deh	DUB	𒁾	sux
dehi	DUB	𒁾	sux
dih	DUB	𒁾	sux
dub	DUB	𒁾	sux
duba	DUB	𒁾	sux
dubba	DUB	𒁾	sux
dubu	DUB	𒁾	sux
dup	DUB	𒁾	sux
kicib3	DUB	𒁾	sux
mebulug3	DUB	𒁾	sux
menbulug3	DUB	𒁾	sux
mes2	DUB	𒁾	sux
samag	DUB	𒁾	sux
simig	DUB	𒁾	sux
sumug	DUB	𒁾	sux
cen4	DUB	𒁾	sux
tehe	DUB	𒁾	sux
tehi	DUB	𒁾	sux
tub	DUB	𒁾	sux
tup	DUB	𒁾	sux
tub	DUB	𒁾	sux
tup	DUB	𒁾	sux
urud2	DUB	𒁾	sux
urudu2	DUB	𒁾	sux
zamug	DUB	𒁾	sux
dibira	|DUB.NAGAR|	𒁾𒉄	sux
tabira	|DUB.NAGAR|	𒁾𒉄	sux
tebiru	|DUB.NAGAR|	𒁾𒉄	sux
tibira	|DUB.NAGAR|	𒁾𒉄	sux
gaz3	|DUB×EŠ₂|	𒁿	sux
MZL565	DUB₂	𒂀	sux
LAK632	DUB₂	𒂀	sux
dim5	DUB₂	𒂀	sux
dub2	DUB₂	𒂀	sux
duba2	DUB₂	𒂀	sux
dubu2	DUB₂	𒂀	sux
dup2	DUB₂	𒂀	sux
sagkurini	DUB₂	𒂀	sux
tig3	DUB₂	𒂀	sux
tu16	DUB₂	𒂀	sux
tub2	DUB₂	𒂀	sux
tunx	DUB₂	𒂀	sux
tup2	DUB₂	𒂀	sux
tub2	DUB₂	𒂀	sux
LAK560	DUG	𒂁	sux
LAK637	DUG	𒂁	sux
LAK639	DUG	𒂁	sux
dug	DUG	𒂁	sux
duk	DUG	𒂁	sux
duka	DUG	𒂁	sux
duq	DUG	𒂁	sux
ebir	DUG	𒂁	sux
epig2	DUG	𒂁	sux
epir	DUG	𒂁	sux
gurin	DUG	𒂁	sux
gurun7	DUG	𒂁	sux
kurum10	DUG	𒂁	sux
kurin	DUG	𒂁	sux
kurun3	DUG	𒂁	sux
lit2	DUG	𒂁	sux
lud	DUG	𒂁	sux
lum3	DUG	𒂁	sux
lumu3	DUG	𒂁	sux
lut	DUG	𒂁	sux
lutu	DUG	𒂁	sux
lut	DUG	𒂁	sux
lutu	DUG	𒂁	sux
si14	DUG	𒂁	sux
cikin2	DUG	𒂁	sux
s,urs,ub	DUG	𒂁	sux
tug3	DUG	𒂁	sux
tuk3	DUG	𒂁	sux
tuq3	DUG	𒂁	sux
ulud	DUG	𒂁	sux
urrub	DUG	𒂁	sux
ursub	DUG	𒂁	sux
urs,ub	DUG	𒂁	sux
urzub	DUG	𒂁	sux
zurzub	DUG	𒂁	sux
baharx	|DUG.BUR|	𒂁𒁓	sux
lumx	|DUG.DUG|	𒂁𒂁	sux
bahar5	|DUG.SILA₃.BUR.NA|	𒂁𒋡𒁓𒈾	sux
LAK392	DUGUD	𒂂	sux
dugux	DUGUD	𒂂	sux
dugud	DUGUD	𒂂	sux
duguda	DUGUD	𒂂	sux
dukudx	DUGUD	𒂂	sux
gi25	DUGUD	𒂂	sux
ji25	DUGUD	𒂂	sux
kaptu	DUGUD	𒂂	sux
qaptu	DUGUD	𒂂	sux
duh	DUH	𒂃	sux
LAK40	DUN	𒂄	sux
MZL744	DUN	𒂄	sux
du24	DUN	𒂄	sux
dun	DUN	𒂄	sux
duna	DUN	𒂄	sux
dur9	DUN	𒂄	sux
duru9	DUN	𒂄	sux
sah3	DUN	𒂄	sux
su17	DUN	𒂄	sux
sul	DUN	𒂄	sux
cah2	DUN	𒂄	sux
cahan3	DUN	𒂄	sux
cul	DUN	𒂄	sux
tun4	DUN	𒂄	sux
zu7	DUN	𒂄	sux
zahdax	|DUN.TUR|	𒂄𒌉	sux
zahdax	|DUN.NE.TUR|	𒂄𒉈𒌉	sux
LAK666	DUN₃	𒂅	sux
du5	DUN₃	𒂅	sux
dug5	DUN₃	𒂅	sux
dulx	DUN₃	𒂅	sux
dun3	DUN₃	𒂅	sux
su18	DUN₃	𒂅	sux
sug5	DUN₃	𒂅	sux
tu18	DUN₃	𒂅	sux
tun3	DUN₃	𒂅	sux
tuna3	DUN₃	𒂅	sux
tug8	DUN₃	𒂅	sux
tu	DUN₃	𒂅	sux
LAK667	DUN₃@g	𒂆	sux
aga3	DUN₃@g	𒂆	sux
aja3	DUN₃@g	𒂆	sux
ge11	DUN₃@g	𒂆	sux
gi11	DUN₃@g	𒂆	sux
gig4	DUN₃@g	𒂆	sux
gij4	DUN₃@g	𒂆	sux
gim2	DUN₃@g	𒂆	sux
gin2	DUN₃@g	𒂆	sux
gina2	DUN₃@g	𒂆	sux
puc4	DUN₃@g	𒂆	sux
aga-us2	|DUN₃@g.UŠ|	𒂆𒍑	sux
uku-uc	|DUN₃@g.UŠ|	𒂆𒍑	sux
LAK154	DUN₃@g@g	𒂇	sux
aga	DUN₃@g@g	𒂇	sux
agu	DUN₃@g@g	𒂇	sux
ir17	DUN₃@g@g	𒂇	sux
mer	DUN₃@g@g	𒂇	sux
mere	DUN₃@g@g	𒂇	sux
migir	DUN₃@g@g	𒂇	sux
mir	DUN₃@g@g	𒂇	sux
miri	DUN₃@g@g	𒂇	sux
nigir	DUN₃@g@g	𒂇	sux
nijir	DUN₃@g@g	𒂇	sux
nimgir	DUN₃@g@g	𒂇	sux
nimirx	DUN₃@g@g	𒂇	sux
ten3	DUN₃@g@g	𒂇	sux
tin3	DUN₃@g@g	𒂇	sux
uku	DUN₃@g@g	𒂇	sux
ukuc	|DUN₃@g@g.UŠ|	𒂇𒍑	sux
nirx	|DUN₃@g@g.ZA|	𒂇𒍝	sux
MZL557	DUN₄	𒂈	sux
dul4	DUN₄	𒂈	sux
dun4	DUN₄	𒂈	sux
migir2	DUN₄	𒂈	sux
nigir2	DUN₄	𒂈	sux
nijir2	DUN₄	𒂈	sux
nimgir2	DUN₄	𒂈	sux
cudul4	DUN₄	𒂈	sux
cudun4	DUN₄	𒂈	sux
cutul4	DUN₄	𒂈	sux
cutun4	DUN₄	𒂈	sux
tul6	DUN₄	𒂈	sux
LAK791	DUR₂	𒂉	sux
dur2	DUR₂	𒂉	sux
duru2	DUR₂	𒂉	sux
durun	DUR₂	𒂉	sux
durum2	DUR₂	𒂉	sux
duruna	DUR₂	𒂉	sux
tur7	DUR₂	𒂉	sux
tur2	DUR₂	𒂉	sux
LAK177?	E	𒂊	sux
e	E	𒂊	sux
eg2	E	𒂊	sux
eki	E	𒂊	sux
i15	E	𒂊	sux
ig2	E	𒂊	sux
curux	E	𒂊	sux
yi3	E	𒂊	sux
kuru	|E.SUD.HUB₂×UD|	𒂊𒋤𒄽	sux
curux	|E.SUD.HUB₂×UD|	𒂊𒋤𒄽	sux
gur21	|E.TUM|	𒂊𒌈	sux
guru21	|E.TUM|	𒂊𒌈	sux
kur14	|E.TUM|	𒂊𒌈	sux
kuru14	|E.TUM|	𒂊𒌈	sux
kurul14	|E.TUM|	𒂊𒌈	sux
curux	|E.TUM|	𒂊𒌈	sux
gurux	|E.TUM.GA₂×NUN&NUN|	𒂊𒌈𒃡	sux
kurulx	|E.TUM.GA₂×NUN&NUN|	𒂊𒌈𒃡	sux
LAK137	|E×PAP|	𒂋	sux
pax	|E×PAP|	𒂋	sux
hilibu	|E&E.NUN&NUN|	𒂌	sux
LAK732	E₂	𒂍	sux
MZL495	E₂	𒂍	sux
)a3	E₂	𒂍	sux
a)3	E₂	𒂍	sux
a14	E₂	𒂍	sux
bītu	E₂	𒂍	sux
bed	E₂	𒂍	sux
bet	E₂	𒂍	sux
betu	E₂	𒂍	sux
bid	E₂	𒂍	sux
bit	E₂	𒂍	sux
biti	E₂	𒂍	sux
bitu	E₂	𒂍	sux
bit	E₂	𒂍	sux
e2	E₂	𒂍	sux
e)3	E₂	𒂍	sux
iski	E₂	𒂍	sux
pet	E₂	𒂍	sux
pid	E₂	𒂍	sux
pit	E₂	𒂍	sux
pit	E₂	𒂍	sux
e)i	|E₂.A|	𒂍𒀀	sux
e)u	|E₂.A|	𒂍𒀀	sux
edurux	|E₂.A|	𒂍𒀀	sux
...ingara	|E₂.AN.ŠE.NAGA|	𒂍𒀭𒊺𒉀	sux
...ingara	|E₂.GIŠ.TUG₂.PI.AN.ŠE.NAGA|	𒂍𒄑𒌆𒉿𒀭𒊺𒉀	sux
eurre	|E₂.KI.SUM.GA|	𒂍𒆠𒋧𒂵	sux
...la	|E₂.KI.SUM.GA|	𒂍𒆠𒋧𒂵	sux
arala	|E₂.KUR.BAD|	𒂍𒆳𒁁	sux
arali	|E₂.KUR.BAD|	𒂍𒆳𒁁	sux
[...]ennu	|E₂.LU₂×GAN₂@t.A|	𒂍𒈂𒀀	sux
itimax	|E₂.MI|	𒂍𒈪	sux
agrun	|E₂.NUN|	𒂍𒉣	sux
agrux	|E₂.NUN|	𒂍𒉣	sux
agrunax	|E₂.NUN|	𒂍𒉣	sux
e2-gar6	|E₂.NUN|	𒂍𒉣	sux
amax	|E₂.SAL|	𒂍𒊩	sux
amex	|E₂.SAL|	𒂍𒊩	sux
egar	|E₂.SIG₄|	𒂍𒋞	sux
igar	|E₂.SIG₄|	𒂍𒋞	sux
ingar	|E₂.SIG₄|	𒂍𒋞	sux
esagx	|E₂.ŠE|	𒂍𒊺	sux
arah4	|E₂.UŠ.BU.DA|	𒂍𒍑𒁍𒁕	sux
araha	|E₂.UŠ.BU.DA|	𒂍𒍑𒁍𒁕	sux
aclug	|E₂.UŠ.BU.DA|	𒂍𒍑𒁍𒁕	sux
edakuax	|E₂×(A.HA.DA)|	𒂎	sux
LAK739	|E₂×GAR|	𒂏	sux
egarax	|E₂×GAR|	𒂏	sux
ejarax	|E₂×GAR|	𒂏	sux
jalgax	|E₂×GAR|	𒂏	sux
gagigx	|E₂×MI|	𒂐	sux
itimax	|E₂×MI|	𒂐	sux
[...]	|E₂×SAL|	𒂑	sux
amax	|E₂×SAL|	𒂑	sux
arhucx	|E₂×SAL|	𒂑	sux
emex	|E₂×SAL|	𒂑	sux
urx	|E₂×SAL|	𒂑	sux
ucx	|E₂×SAL|	𒂑	sux
arahx	|E₂×ŠE|	𒂒	sux
esagx	|E₂×ŠE|	𒂒	sux
usix	|E₂×ŠE|	𒂒	sux
LAK737	|E₂×U|	𒂓	sux
sadx	|E₂×U|	𒂓	sux
ulax	|E₂×U|	𒂓	sux
LAK747	EDIN	𒂔	sux
bilx	EDIN	𒂔	sux
bir4	EDIN	𒂔	sux
dinx	EDIN	𒂔	sux
eden	EDIN	𒂔	sux
edena	EDIN	𒂔	sux
edimx	EDIN	𒂔	sux
edin	EDIN	𒂔	sux
edina	EDIN	𒂔	sux
eru5	EDIN	𒂔	sux
erua2	EDIN	𒂔	sux
girx	EDIN	𒂔	sux
gurx	EDIN	𒂔	sux
idenx	EDIN	𒂔	sux
la8	EDIN	𒂔	sux
rabita	EDIN	𒂔	sux
ri10	EDIN	𒂔	sux
ribx	EDIN	𒂔	sux
ru6	EDIN	𒂔	sux
eger	EGIR	𒂕	sux
egera	EGIR	𒂕	sux
egir	EGIR	𒂕	sux
ejer	EGIR	𒂕	sux
ejera	EGIR	𒂕	sux
ejir	EGIR	𒂕	sux
lumhax	EGIR	𒂕	sux
tum13	EGIR	𒂕	sux
dam0	EL	𒂖	sux
el	EL	𒂖	sux
ele2	EL	𒂖	sux
ec14	EL	𒂖	sux
il5	EL	𒂖	sux
ili5	EL	𒂖	sux
ram0	EL	𒂖	sux
sikil	EL	𒂖	sux
ELLES396	ELLES396	𒍡	sux
zamx	ELLES396	𒍡	sux
LAK532	EN	𒂗	sux
adx	EN	𒂗	sux
amx	EN	𒂗	sux
en	EN	𒂗	sux
ena	EN	𒂗	sux
eni	EN	𒂗	sux
enu	EN	𒂗	sux
in4	EN	𒂗	sux
ru12	EN	𒂗	sux
uru16	EN	𒂗	sux
urunx	EN	𒂗	sux
enegi3	|EN.DIM₂.GIG|	𒂗𒁶░░	sux
enegir3	|EN.DIM₂.GIG|	𒂗𒁶░░	sux
ennigi3	|EN.DIM₂.GIG|	𒂗𒁶░░	sux
engizx	|EN.GI|	𒂗𒄀	sux
tungal2	|EN.KI|	𒂗𒆠	sux
tunjal2	|EN.KI|	𒂗𒆠	sux
ellil	|EN.KID|	𒂗𒆤	sux
en-lil2	|EN.KID|	𒂗𒆤	sux
illil	|EN.KID|	𒂗𒆤	sux
nibri	|EN.KID|	𒂗𒆤	sux
nibru	|EN.KID|	𒂗𒆤	sux
mudru2	|EN.KU.A|	𒂗𒆪𒀀	sux
ensix	|EN.LI|	𒂗𒇷	sux
macda4	|EN.MAŠ.KAK|	𒂗𒈦𒆕	sux
cennu	|EN.ME.AD.KU₃|	𒂗𒈨𒀜𒆬	sux
ukurrim	|EN.ME.AN.MUŠ₃|	𒂗𒈨𒀭𒈹	sux
engiz	|EN.ME.GI|	𒂗𒈨𒄀	sux
murub3	|EN.ME.LAGAR|	𒂗𒈨𒇬	sux
ensi	|EN.ME.LI|	𒂗𒈨𒇷	sux
ceclam2	|EN.ME.LI|	𒂗𒈨𒇷	sux
endib	|EN.ME.MU|	𒂗𒈨𒈬	sux
endub	|EN.ME.MU|	𒂗𒈨𒈬	sux
endib	|EN.ME.ZI.AN.NA|	𒂗𒈨𒍣𒀭𒈾	sux
nunuzzix	|EN.NU.NUNUZ.ZI.AN.UD|	𒂗𒉡𒉭𒍣𒀭𒌓	sux
ennigi2	|EN.NUNUZ.DIM₂|	𒂗𒉭𒁶	sux
zirru	|EN.NUNUZ.ZI.AN.ŠEŠ.KI|	𒂗𒉭𒍣𒀭𒋀𒆠	sux
nunuzzi	|EN.NUNUZ.ZI.AN.UD|	𒂗𒉭𒍣𒀭𒌓	sux
nuzzi	|EN.NUNUZ.ZI.AN.UD|	𒂗𒉭𒍣𒀭𒌓	sux
enkum	|EN.PAP.IGI@g.NUN.ME.EZEN×KASKAL|	𒂗𒉽𒅊𒉣𒈨𒂬	sux
zirrux	|EN.SAL.ME.NUNUZ.ZI.AN.ŠEŠ.KI|	𒂗𒊩𒈨𒉭𒍣𒀭𒋀𒆠	sux
suruen	|EN.ŠEŠ|	𒂗𒋀	sux
ebeh	|EN.TI|	𒂗𒋾	sux
ebih	|EN.TI|	𒂗𒋾	sux
sin3	|EN.ZU|	𒂗𒍪	sux
suen	|EN.ZU|	𒂗𒍪	sux
suena	|EN.ZU|	𒂗𒍪	sux
tungal	|EN.ZU|	𒂗𒍪	sux
zuen	|EN.ZU|	𒂗𒍪	sux
zuena	|EN.ZU|	𒂗𒍪	sux
merimer2	|4×EN|	𒂝	sux
merimeri2	|4×EN|	𒂝	sux
mermer2	|4×EN|	𒂝	sux
mermeri2	|4×EN|	𒂝	sux
LAK531	|EN×GAN₂@t|	𒂙	sux
bar8	|EN×GAN₂@t|	𒂙	sux
bur14	|EN×GAN₂@t|	𒂙	sux
buru14	|EN×GAN₂@t|	𒂙	sux
ebur	|EN×GAN₂@t|	𒂙	sux
eburux	|EN×GAN₂@t|	𒂙	sux
enkar	|EN×GAN₂@t|	𒂙	sux
enkara	|EN×GAN₂@t|	𒂙	sux
ecgiri2	|EN×GAN₂@t|	𒂙	sux
eckiri2	|EN×GAN₂@t|	𒂙	sux
geccir	|EN×GAN₂@t|	𒂙	sux
giccir	|EN×GAN₂@t|	𒂙	sux
jeccir	|EN×GAN₂@t|	𒂙	sux
jiccir	|EN×GAN₂@t|	𒂙	sux
ru13	|EN×GAN₂@t|	𒂙	sux
sibir2	|EN×GAN₂@t|	𒂙	sux
sullim	|EN×GAN₂@t|	𒂙	sux
cibir2	|EN×GAN₂@t|	𒂙	sux
enme	|EN×ME|	𒂚	sux
ensi3	|EN×ME|	𒂚	sux
engiz2	|EN×ME.GI|	𒂚𒄀	sux
adamen5	|EN%EN|	𒂛	sux
adamin5	|EN%EN|	𒂛	sux
dalhamun2	|EN%EN|	𒂛	sux
merimer	|EN%EN|	𒂛	sux
merimeri	|EN%EN|	𒂛	sux
mermer	|EN%EN|	𒂛	sux
mermeri	|EN%EN|	𒂛	sux
nigir3	|EN%EN|	𒂛	sux
nimgigri	|EN%EN|	𒂛	sux
nimgirgirri	|EN%EN|	𒂛	sux
urbigu2	|EN%EN|	𒂛	sux
urbingu2	|EN%EN|	𒂛	sux
dalhamun3	|EN%EN.IM%IM|	𒂛𒅐	sux
nimgigri2	|EN%EN.IM%IM|	𒂛𒅐	sux
nimgirgirri2	|EN%EN.IM%IM|	𒂛𒅐	sux
adaminx	|EN@EN|	𒂜	sux
LAK671	EREN	𒂞	sux
eren	EREN	𒂞	sux
erena	EREN	𒂞	sux
erin	EREN	𒂞	sux
erina	EREN	𒂞	sux
sux	EREN	𒂞	sux
ce22	EREN	𒂞	sux
cec4	EREN	𒂞	sux
curmenx	|EREN.ŠU.ME|	𒂞𒋗𒈨	sux
LAK527	ERIN₂	𒂟	sux
s,ab	ERIN₂	𒂟	sux
s,ābu	ERIN₂	𒂟	sux
bir3	ERIN₂	𒂟	sux
erem	ERIN₂	𒂟	sux
eren2	ERIN₂	𒂟	sux
erena2	ERIN₂	𒂟	sux
erim	ERIN₂	𒂟	sux
erin2	ERIN₂	𒂟	sux
erina2	ERIN₂	𒂟	sux
hic3	ERIN₂	𒂟	sux
lah2	ERIN₂	𒂟	sux
lih2	ERIN₂	𒂟	sux
nura	ERIN₂	𒂟	sux
nuri	ERIN₂	𒂟	sux
nuru	ERIN₂	𒂟	sux
par5	ERIN₂	𒂟	sux
pir2	ERIN₂	𒂟	sux
rin2	ERIN₂	𒂟	sux
rina2	ERIN₂	𒂟	sux
sap2	ERIN₂	𒂟	sux
surx	ERIN₂	𒂟	sux
s,ab	ERIN₂	𒂟	sux
s,ap	ERIN₂	𒂟	sux
s,apa	ERIN₂	𒂟	sux
tam5	ERIN₂	𒂟	sux
udax	ERIN₂	𒂟	sux
zab	ERIN₂	𒂟	sux
zalag2	ERIN₂	𒂟	sux
zap	ERIN₂	𒂟	sux
urume	|ERIN₂.NA|	𒂟𒈾	sux
LAK794	EŠ₂	𒂠	sux
ege	EŠ₂	𒂠	sux
eger2	EŠ₂	𒂠	sux
egi	EŠ₂	𒂠	sux
egir2	EŠ₂	𒂠	sux
ec2	EŠ₂	𒂠	sux
ece2	EŠ₂	𒂠	sux
ge7	EŠ₂	𒂠	sux
ger15	EŠ₂	𒂠	sux
gi7	EŠ₂	𒂠	sux
gir15	EŠ₂	𒂠	sux
je7	EŠ₂	𒂠	sux
jer15	EŠ₂	𒂠	sux
ji7	EŠ₂	𒂠	sux
jir15	EŠ₂	𒂠	sux
hug	EŠ₂	𒂠	sux
huj	EŠ₂	𒂠	sux
hun	EŠ₂	𒂠	sux
ic9	EŠ₂	𒂠	sux
izid	EŠ₂	𒂠	sux
nah2	EŠ₂	𒂠	sux
samanx	EŠ₂	𒂠	sux
ca16	EŠ₂	𒂠	sux
ce3	EŠ₂	𒂠	sux
ci4	EŠ₂	𒂠	sux
cu3	EŠ₂	𒂠	sux
s,i9	EŠ₂	𒂠	sux
ub2	EŠ₂	𒂠	sux
uba2	EŠ₂	𒂠	sux
up2	EŠ₂	𒂠	sux
ecemen3	|EŠ₂.HUL₂|	𒂠𒄾	sux
ecemin3	|EŠ₂.HUL₂|	𒂠𒄾	sux
sura13	|EŠ₂.KA|	𒂠𒅗	sux
surra13	|EŠ₂.KA|	𒂠𒅗	sux
zir2	|EŠ₂.KA|	𒂠𒅗	sux
titabx	|ZI₃.LU₃|	𒍥𒈖	sux
ebih2	|EŠ₂.MAH|	𒂠𒈤	sux
ce3-munu4	|EŠ₂.PAP.PAP|	𒂠𒉽𒉽	sux
saman	|EŠ₂.SUD.NUN.EŠ₂.TU|	𒂠𒋤𒉣𒂠𒌅	sux
samanurx	|EŠ₂.SUD.NUN.EŠ₂.TU|	𒂠𒋤𒉣𒂠𒌅	sux
samun+	|EŠ₂.SUD.NUN.EŠ₂.TU|	𒂠𒋤𒉣𒂠𒌅	sux
caman+	|EŠ₂.SUD.NUN.EŠ₂.TU|	𒂠𒋤𒉣𒂠𒌅	sux
camanur+	|EŠ₂.SUD.NUN.EŠ₂.TU|	𒂠𒋤𒉣𒂠𒌅	sux
saman2~a	|EŠ₂.BU.NUN.EŠ₂.TU|	𒂠𒁍𒉣𒂠𒌅	sux
samanurx~a	|EŠ₂.BU.NUN.EŠ₂.TU|	𒂠𒁍𒉣𒂠𒌅	sux
saman3~b	|ŠE.EŠ₂.NUN.BU|	𒊺𒂠𒉣𒁍	sux
samanx~d	|SUD.NUN.ŠE.EŠ₂|	𒋤𒉣𒊺𒂠	sux
samanx~e	|TUG₂.BU.TUG₂.TU|	𒌆𒁍𒌆𒌅	sux
samanx~f	|BU.NUN.ŠE.EŠ₂|	𒁍𒉣𒊺𒂠	sux
samanx~g	|KU.BU.NUN.TU.KU|	𒆪𒁍𒉣𒌅𒆪	sux
LAK794~h	EŠ₂	𒂠	sux
samanx~h	EŠ₂	𒂠	sux
samanx~x	|NUN.ŠE.LAL|	𒉣𒊺𒇲	sux
dabin	|EŠ₂.ŠE|	𒂠𒊺	sux
zikumx	|EŠ₂.UD|	𒂠𒌓	sux
zi3-kum4	|EŠ₂.UD|	𒂠𒌓	sux
gurx	ZI₃	𒍥	sux
gurux	ZI₃	𒍥	sux
karx	ZI₃	𒍥	sux
karax	ZI₃	𒍥	sux
kirix	ZI₃	𒍥	sux
zi3	ZI₃	𒍥	sux
zid2	ZI₃	𒍥	sux
zux	ZI₃	𒍥	sux
asilx	EZEN	𒂡	sux
asilax	EZEN	𒂡	sux
asilalx	EZEN	𒂡	sux
badx	EZEN	𒂡	sux
esen	EZEN	𒂡	sux
esin	EZEN	𒂡	sux
ezem	EZEN	𒂡	sux
ezema	EZEN	𒂡	sux
ezen	EZEN	𒂡	sux
ezena	EZEN	𒂡	sux
ezin	EZEN	𒂡	sux
izen	EZEN	𒂡	sux
izim	EZEN	𒂡	sux
izin	EZEN	𒂡	sux
izun	EZEN	𒂡	sux
ser3	EZEN	𒂡	sux
sidra	EZEN	𒂡	sux
silx	EZEN	𒂡	sux
sir3	EZEN	𒂡	sux
sirda	EZEN	𒂡	sux
sirim2	EZEN	𒂡	sux
cer3	EZEN	𒂡	sux
cir3	EZEN	𒂡	sux
MZL288	|EZEN×A|	𒂢	sux
asil3	|EZEN×A|	𒂢	sux
asila3	|EZEN×A|	𒂢	sux
asilal3	|EZEN×A|	𒂢	sux
asillal3	|EZEN×A|	𒂢	sux
murgicur	|EZEN×A|	𒂢	sux
numgicur	|EZEN×A|	𒂢	sux
sil6	|EZEN×A|	𒂢	sux
silal	|EZEN×A|	𒂢	sux
asil5	|EZEN×(A.LAL)|	𒂣	sux
asila5	|EZEN×(A.LAL)|	𒂣	sux
asilal5	|EZEN×(A.LAL)|	𒂣	sux
sil7	|EZEN×(A.LAL)|	𒂣	sux
asil4	|EZEN×(A.LAL₂)|	𒂤	sux
asila4	|EZEN×(A.LAL₂)|	𒂤	sux
asilal4	|EZEN×(A.LAL₂)|	𒂤	sux
sil9	|EZEN×(A.LAL₂)|	𒂤	sux
LAK613	|EZEN×AN|	𒂥	sux
ux	|EZEN×AN|	𒂥	sux
anx	|EZEN×BAD|	𒂦	sux
ba8	|EZEN×BAD|	𒂦	sux
bad3	|EZEN×BAD|	𒂦	sux
bada3	|EZEN×BAD|	𒂦	sux
bat3	|EZEN×BAD|	𒂦	sux
dur8	|EZEN×BAD|	𒂦	sux
durum	|EZEN×BAD|	𒂦	sux
u9	|EZEN×BAD|	𒂦	sux
ubx	|EZEN×BAD|	𒂦	sux
ug5	|EZEN×BAD|	𒂦	sux
uga5	|EZEN×BAD|	𒂦	sux
uj5	|EZEN×BAD|	𒂦	sux
uk5	|EZEN×BAD|	𒂦	sux
un3	|EZEN×BAD|	𒂦	sux
uq5	|EZEN×BAD|	𒂦	sux
dūru	|EZEN×BAD.AN|	𒂦𒀭	sux
dugin	|EZEN×DUN₃@g|	𒂧	sux
dugina	|EZEN×DUN₃@g|	𒂧	sux
dugin2	|EZEN×DUN₃@g@g|	𒂨	sux
dugina2	|EZEN×DUN₃@g@g|	𒂨	sux
mir5	|EZEN×DUN₃@g@g|	𒂨	sux
akcakx	|EZEN×HA|	𒂩	sux
udnimx	|EZEN×HA|	𒂩	sux
LAK616	|EZEN×KASKAL|	𒂬	sux
asilax	|EZEN×KASKAL|	𒂬	sux
kum3	|EZEN×KASKAL|	𒂬	sux
sil5	|EZEN×KASKAL|	𒂬	sux
sud5	|EZEN×KASKAL|	𒂬	sux
ubar	|EZEN×KASKAL|	𒂬	sux
ubara	|EZEN×KASKAL|	𒂬	sux
ul5	|EZEN×KASKAL|	𒂬	sux
umbara	|EZEN×KASKAL|	𒂬	sux
un4	|EZEN×KASKAL|	𒂬	sux
usigi	|EZEN×KASKAL|	𒂬	sux
gugu2	|4×(EZEN×KASKAL)|	𒂭	sux
kisig	|EZEN×KU₃|	𒂮	sux
kisiga	|EZEN×KU₃|	𒂮	sux
kicag	|EZEN×KU₃|	𒂮	sux
silalx	|EZEN×KU₃|	𒂮	sux
udnimx	|EZEN×KU₃|	𒂮	sux
LAK615	|EZEN×LA|	𒂯	sux
gubalag	|EZEN×LA|	𒂯	sux
gubalaga	|EZEN×LA|	𒂯	sux
gublaga	|EZEN×LA|	𒂯	sux
laban	|EZEN×LA|	𒂯	sux
asil	|EZEN×LAL₂|	𒂰	sux
asila	|EZEN×LAL₂|	𒂰	sux
asilal	|EZEN×LAL₂|	𒂰	sux
silx	|EZEN×LAL₂|	𒂰	sux
libin	|EZEN×LI|	𒂱	sux
lubun	|EZEN×LU|	𒂲	sux
gumle	|EZEN×IGI@g|	𒂫	sux
kisig2	|EZEN×IGI@g|	𒂫	sux
udinim	|EZEN×IGI@g|	𒂫	sux
udnim	|EZEN×IGI@g|	𒂫	sux
usil	|EZEN×U₂|	𒂳	sux
asil6	|EZEN×UD|	𒂴	sux
asila6	|EZEN×UD|	𒂴	sux
asilal6	|EZEN×UD|	𒂴	sux
sil10	|EZEN×UD|	𒂴	sux
sillal	|EZEN×UD|	𒂴	sux
LAK726	GA	𒂵	sux
ebir4	GA	𒂵	sux
epir4	GA	𒂵	sux
ga	GA	𒂵	sux
gar9	GA	𒂵	sux
gara9	GA	𒂵	sux
ge20	GA	𒂵	sux
gu11	GA	𒂵	sux
gur11	GA	𒂵	sux
ha7	GA	𒂵	sux
ka3	GA	𒂵	sux
kur15	GA	𒂵	sux
qa2	GA	𒂵	sux
cizbu	GA	𒂵	sux
gar11	|GA.A|	𒂵𒀀	sux
gara11	|GA.A|	𒂵𒀀	sux
gar12	|GA.DIŠ|	𒂵𒁹	sux
garx	|GA.GA|	𒂵𒂵	sux
pecx	|GA.KAD₃|	𒂵𒆑	sux
LAK728	|GA.KASKAL|	𒂵𒆜	sux
gaec	|GA.KASKAL|	𒂵𒆜	sux
gaic	|GA.KASKAL|	𒂵𒆜	sux
garax	|GA.KASKAL|	𒂵𒆜	sux
garac3	|GA.KASKAL|	𒂵𒆜	sux
kisim6	|GA.LAGAB|	𒂵𒆸	sux
gar10	|GA.NI|	𒂵𒉌	sux
gara10	|GA.NI|	𒂵𒉌	sux
LAK727	GA@g	𒂶	sux
gar2	GA@g	𒂶	sux
gara2	GA@g	𒂶	sux
LAK674	GA₂	𒂷	sux
alba	GA₂	𒂷	sux
ba4	GA₂	𒂷	sux
bisag	GA₂	𒂷	sux
bisaj	GA₂	𒂷	sux
bisan	GA₂	𒂷	sux
ecda3	GA₂	𒂷	sux
ga2	GA₂	𒂷	sux
ge26	GA₂	𒂷	sux
ja2	GA₂	𒂷	sux
je26	GA₂	𒂷	sux
ilba	GA₂	𒂷	sux
ma3	GA₂	𒂷	sux
mal	GA₂	𒂷	sux
mala	GA₂	𒂷	sux
pisag	GA₂	𒂷	sux
pisaj	GA₂	𒂷	sux
pisan	GA₂	𒂷	sux
ca13	GA₂	𒂷	sux
edakua	|GA₂×(A.DA.HA)|	𒂸	sux
edakuax~a	|GA₂×(A.HA)|	𒂹	sux
alimx	|GA₂×(A.IGI)|	𒂺	sux
pi7	|GA₂×(A.IGI)|	𒂺	sux
piru	|GA₂×(A.IGI)|	𒂺	sux
gakis,s,u	|GA₂×(AB₂@t.TAB)|	𒂻	sux
LAK675	|GA₂×AN|	𒂼	sux
ama	|GA₂×AN|	𒂼	sux
ame	|GA₂×AN|	𒂼	sux
ami	|GA₂×AN|	𒂼	sux
ammax	|GA₂×AN|	𒂼	sux
arhuc4	|GA₂×AN|	𒂼	sux
dagal	|GA₂×AN|	𒂼	sux
dagala	|GA₂×AN|	𒂼	sux
dajal	|GA₂×AN|	𒂼	sux
damal	|GA₂×AN|	𒂼	sux
/damal/	|GA₂×AN|	𒂼	sux
eme4	|GA₂×AN|	𒂼	sux
hegal	|GA₂×AN|	𒂼	sux
imi2	|GA₂×AN|	𒂼	sux
max	|GA₂×AN|	𒂼	sux
caganx	|GA₂×AN|	𒂼	sux
cakkan7	|GA₂×AN|	𒂼	sux
amedu	|GA₂×AN.A.TU|	𒂼𒀀𒌅	sux
eme4-e4-du2	|GA₂×AN.A.TU|	𒂼𒀀𒌅	sux
emedu2	|GA₂×AN.A.TU|	𒂼𒀀𒌅	sux
agarim	|GA₂×AN.AN.MUŠ₃|	𒂼𒀭𒈹	sux
amalu	|GA₂×AN.AN.MUŠ₃|	𒂼𒀭𒈹	sux
amarim	|GA₂×AN.AN.MUŠ₃|	𒂼𒀭𒈹	sux
agarin3	|GA₂×AN.DUN₃@g|	𒂼𒂆	sux
ajarin3	|GA₂×AN.DUN₃@g|	𒂼𒂆	sux
usud	|GA₂×AN.KAK.A|	𒂼𒆕𒀀	sux
amalug	|GA₂×AN.LUL|	𒂼𒈜	sux
malug	|GA₂×AN.LUL|	𒂼𒈜	sux
agarin4	|GA₂×AN.ŠIM|	𒂼𒋆	sux
ajarin4	|GA₂×AN.ŠIM|	𒂼𒋆	sux
agarin5	|GA₂×AN.ŠIM×GAR|	𒂼𒋋	sux
ajarin5	|GA₂×AN.ŠIM×GAR|	𒂼𒋋	sux
garinx	|GA₂×AN.ŠIM×GAR|	𒂼𒋋	sux
eme4-du2	|GA₂×AN.TU|	𒂼𒌅	sux
emedu	|GA₂×AN.TU|	𒂼𒌅	sux
ka...	|GA₂×AN.X|	𒂼░░	sux
gaiku	|GA₂×AŠ|	𒂽	sux
jaiku	|GA₂×AŠ|	𒂽	sux
iku2	|GA₂×AŠ|	𒂽	sux
gazigal	|GA₂×(AŠ₂.GAL)|	𒂾	sux
etutumx	|GA₂×BAD|	𒂿	sux
etutu	|GA₂×BAD|	𒂿	sux
sabad2	|GA₂×BAD|	𒂿	sux
sad3	|GA₂×BAD|	𒂿	sux
tilhar	|GA₂×BAD|	𒂿	sux
eburra	|GA₂×(BAR.RA)|	𒃀	sux
gaburra	|GA₂×(BAR.RA)|	𒃀	sux
LAK699	|GA₂×BUR|	𒃁	sux
jaburrax	|GA₂×BUR|	𒃁	sux
gaburra	|GA₂×(BUR.RA)|	𒃂	sux
jaburra	|GA₂×(BUR.RA)|	𒃂	sux
dan7	|GA₂×DA|	𒃃	sux
tan7	|GA₂×DA|	𒃃	sux
LAK686	|GA₂×DI|	𒃄	sux
edi	|GA₂×DI|	𒃄	sux
gadi	|GA₂×DI|	𒃄	sux
munu3	|GA₂×DIM×ŠE|	𒃅	sux
emedub	|GA₂×DUB|	𒃆	sux
gadub	|GA₂×DUB|	𒃆	sux
jasikillax	|GA₂×EL|	𒃇	sux
e)ella	|GA₂×(EL.LA)|	𒃈	sux
esikilla	|GA₂×(EL.LA)|	𒃈	sux
gasikilla	|GA₂×(EL.LA)|	𒃈	sux
jasikilla	|GA₂×(EL.LA)|	𒃈	sux
LAK682	|GA₂×EN|	𒃉	sux
menx	|GA₂×EN|	𒃉	sux
esibir	|GA₂×EN×GAN₂@t|	𒃊	sux
gasibir	|GA₂×EN×GAN₂@t|	𒃊	sux
jasibir	|GA₂×EN×GAN₂@t|	𒃊	sux
janunx	|GA₂×EN.NUN|	𒃉𒉣	sux
dan4	|GA₂×GAN₂@t|	𒃋	sux
tan4	|GA₂×GAN₂@t|	𒃋	sux
LAK691	|GA₂×GAR|	𒃌	sux
egara	|GA₂×GAR|	𒃌	sux
ejara	|GA₂×GAR|	𒃌	sux
galga	|GA₂×GAR|	𒃌	sux
jalga	|GA₂×GAR|	𒃌	sux
ichara	|GA₂×GAR|	𒃌	sux
ichuru	|GA₂×GAR|	𒃌	sux
malga	|GA₂×GAR|	𒃌	sux
LAK680	|GA₂×GI|	𒃍	sux
bisagx	|GA₂×GI|	𒃍	sux
bisanx	|GA₂×GI|	𒃍	sux
gagi2	|GA₂×GI|	𒃍	sux
gagia2	|GA₂×GI|	𒃍	sux
gurdub	|GA₂×GI|	𒃍	sux
pisagx	|GA₂×GI|	𒃍	sux
pisanx	|GA₂×GI|	𒃍	sux
LAK681	|GA₂×GI₄|	𒃎	sux
egia	|GA₂×GI₄|	𒃎	sux
gagi	|GA₂×GI₄|	𒃎	sux
gagia	|GA₂×GI₄|	𒃎	sux
gurdub2	|GA₂×GI₄|	𒃎	sux
jagia	|GA₂×GI₄|	𒃎	sux
pisagx	|GA₂×GI₄|	𒃎	sux
pisanx	|GA₂×GI₄|	𒃎	sux
jagiax	|GA₂×(GI₄.A)|	𒃏	sux
egirsu	|GA₂×(GIR₂.SU)|	𒃐	sux
gagirsu	|GA₂×(GIR₂.SU)|	𒃐	sux
jajirsu	|GA₂×(GIR₂.SU)|	𒃐	sux
halubba	|GA₂×(HA.LU.EŠ₂)|	𒃑	sux
jahallax	|GA₂×HAL|	𒃒	sux
ehalla	|GA₂×(HAL.LA)|	𒃓	sux
gahalla	|GA₂×(HAL.LA)|	𒃓	sux
jahalla	|GA₂×(HAL.LA)|	𒃓	sux
ehili	|GA₂×(HI.LI)|	𒃔	sux
gahili	|GA₂×(HI.LI)|	𒃔	sux
jahili	|GA₂×(HI.LI)|	𒃔	sux
garac	|GA₂×HUB₂|	𒃕	sux
ichuru5	|GA₂×(IŠ.HU.AŠ)|	𒃗	sux
ichurum5	|GA₂×(IŠ.HU.AŠ)|	𒃗	sux
am4	|GA₂×KAK|	𒃘	sux
ama4	|GA₂×KAK|	𒃘	sux
me7	|GA₂×KASKAL|	𒃙	sux
jalillax	|GA₂×KID|	𒃚	sux
elilla	|GA₂×(KID.LAL)|	𒃛	sux
galilla	|GA₂×(KID.LAL)|	𒃛	sux
jalilla	|GA₂×(KID.LAL)|	𒃛	sux
eazag	|GA₂×(KU₃.AN)|	𒃜	sux
ga)azag	|GA₂×(KU₃.AN)|	𒃜	sux
gazag	|GA₂×(KU₃.AN)|	𒃜	sux
jasag	|GA₂×(KU₃.AN)|	𒃜	sux
dajalx	|GA₂×LA|	𒃝	sux
dan2	|GA₂×(ME.EN)|	𒃞	sux
era3	|GA₂×(ME.EN)|	𒃞	sux
eri15	|GA₂×(ME.EN)|	𒃞	sux
men	|GA₂×(ME.EN)|	𒃞	sux
menax	|GA₂×(ME.EN)|	𒃞	sux
mi4	|GA₂×(ME.EN)|	𒃞	sux
min7	|GA₂×(ME.EN)|	𒃞	sux
tan2	|GA₂×(ME.EN)|	𒃞	sux
gagig	|GA₂×MI|	𒃟	sux
idi	|GA₂×MI|	𒃟	sux
itim	|GA₂×MI|	𒃟	sux
itima	|GA₂×MI|	𒃟	sux
utima	|GA₂×MI|	𒃟	sux
LAK678	|GA₂×NUN|	𒃠	sux
ganun	|GA₂×NUN|	𒃠	sux
janun	|GA₂×NUN|	𒃠	sux
ucuc	|GA₂×NUN|	𒃠	sux
LAK679	|GA₂×NUN&NUN|	𒃡	sux
gucur	|GA₂×NUN&NUN|	𒃡	sux
jucur	|GA₂×NUN&NUN|	𒃡	sux
ur3	|GA₂×NUN&NUN|	𒃡	sux
ura3	|GA₂×NUN&NUN|	𒃡	sux
uru12	|GA₂×NUN&NUN|	𒃡	sux
LAK676	|GA₂×PA|	𒃢	sux
MZL408	|GA₂×PA|	𒃢	sux
era4	|GA₂×PA|	𒃢	sux
eri16	|GA₂×PA|	𒃢	sux
ichara4	|GA₂×PA|	𒃢	sux
ichur4	|GA₂×PA|	𒃢	sux
ichuru4	|GA₂×PA|	𒃢	sux
sila4	|GA₂×PA|	𒃢	sux
silaku	|GA₂×PA|	𒃢	sux
LAK698	|GA₂×SAL|	𒃣	sux
[...]	|GA₂×SAL|	𒃣	sux
am5	|GA₂×SAL|	𒃣	sux
ama5	|GA₂×SAL|	𒃣	sux
ame2	|GA₂×SAL|	𒃣	sux
ami2	|GA₂×SAL|	𒃣	sux
arhuc	|GA₂×SAL|	𒃣	sux
eme8	|GA₂×SAL|	𒃣	sux
ur14	|GA₂×SAL|	𒃣	sux
uc3	|GA₂×SAL|	𒃣	sux
gazi3	|GA₂×SAR|	𒃤	sux
bara10	|GA₂×IGI@g|	𒃖	sux
gaga	|GA₂×IGI@g|	𒃖	sux
galgax	|GA₂×IGI@g|	𒃖	sux
sabad3	|GA₂×IGI@g|	𒃖	sux
sad4	|GA₂×IGI@g|	𒃖	sux
gazi2	|GA₂×SUM|	𒃨	sux
arah3	|GA₂×ŠE|	𒃥	sux
asagx	|GA₂×ŠE|	𒃥	sux
esag2	|GA₂×ŠE|	𒃥	sux
esaj2	|GA₂×ŠE|	𒃥	sux
usi	|GA₂×ŠE|	𒃥	sux
esagtur	|GA₂×(ŠE.TUR)|	𒃦	sux
esajtur	|GA₂×(ŠE.TUR)|	𒃦	sux
emedub2	|GA₂×ŠID|	𒃧	sux
dan3	|GA₂×TAK₄|	𒃩	sux
tan3	|GA₂×TAK₄|	𒃩	sux
dagx	|GA₂×U|	𒃪	sux
sabad	|GA₂×U|	𒃪	sux
sad2	|GA₂×U|	𒃪	sux
ula2	|GA₂×U|	𒃪	sux
LAK697	|GA₂×UD|	𒃫	sux
erim4	|GA₂×UD|	𒃫	sux
erin4	|GA₂×UD|	𒃫	sux
etam	|GA₂×UD|	𒃫	sux
karam	|GA₂×UD|	𒃫	sux
...e	|GA₂×(UD.DU)|	𒃬	sux
lirumx	|GA₂&GA₂|	𒃭	sux
LAK119	GABA	𒃮	sux
du8	GABA	𒃮	sux
dudda	GABA	𒃮	sux
duh	GABA	𒃮	sux
ga15	GABA	𒃮	sux
gab	GABA	𒃮	sux
gaba	GABA	𒃮	sux
gap	GABA	𒃮	sux
irtu	GABA	𒃮	sux
pitru	GABA	𒃮	sux
qab	GABA	𒃮	sux
qap	GABA	𒃮	sux
tah2	GABA	𒃮	sux
tu24	GABA	𒃮	sux
tuh	GABA	𒃮	sux
tuhu	GABA	𒃮	sux
tah2	GABA	𒃮	sux
tuh	GABA	𒃮	sux
tu5	GABA	𒃮	sux
MZL157	GAD	𒃰	sux
LAK46	GAD	𒃰	sux
LAK285	GAD	𒃰	sux
gad	GAD	𒃰	sux
gada	GAD	𒃰	sux
gadu	GAD	𒃰	sux
gat	GAD	𒃰	sux
gid4	GAD	𒃰	sux
gida4	GAD	𒃰	sux
kad	GAD	𒃰	sux
kat	GAD	𒃰	sux
kid9	GAD	𒃰	sux
kit9	GAD	𒃰	sux
kut2	GAD	𒃰	sux
qad3	GAD	𒃰	sux
qat3	GAD	𒃰	sux
qat3	GAD	𒃰	sux
qid4	GAD	𒃰	sux
[...]	|GAD.DUN₃|	𒃰𒂅	sux
akkil3	|GAD.TAK₄|	𒃰𒋺	sux
acca2	|GAD.TAK₄|	𒃰𒋺	sux
acta	|GAD.TAK₄|	𒃰𒋺	sux
kil4	|GAD.TAK₄|	𒃰𒋺	sux
[...]	|GAD.TAK₄.GIŠ|	𒃰𒋺𒄑	sux
...gi	|GAD.TAK₄.GIŠ|	𒃰𒋺𒄑	sux
gim8	|GAD.TAK₄.GIŠ|	𒃰𒋺𒄑	sux
seg8	|GAD.TAK₄.GIŠ|	𒃰𒋺𒄑	sux
sig8	|GAD.TAK₄.GIŠ|	𒃰𒋺𒄑	sux
uruaka	|GAD.TAK₄.GIŠ|	𒃰𒋺𒄑	sux
uruicdua	|GAD.TAK₄.GIŠ|	𒃰𒋺𒄑	sux
uruicduha	|GAD.TAK₄.GIŠ|	𒃰𒋺𒄑	sux
urulla	|GAD.TAK₄.GIŠ|	𒃰𒋺𒄑	sux
akkil	|GAD.TAK₄.SI|	𒃰𒋺𒋛	sux
kinda	|GAD&GAD.GAR&GAR|	𒃱	sux
LAK164	GAL	𒃲	sux
gal	GAL	𒃲	sux
gala8	GAL	𒃲	sux
gale	GAL	𒃲	sux
kal2	GAL	𒃲	sux
qal	GAL	𒃲	sux
rab2	GAL	𒃲	sux
rap2	GAL	𒃲	sux
erec5	|GAL.AN.ZU|	𒃲𒀭𒍪	sux
acgabgalx	|GAL.AŠGAB|	𒃲𒀿	sux
bahargalx	|GAL.BAR.EDIN|	𒃲𒁇𒂔	sux
ucumgal	|GAL.BUR₂|	𒃲𒁔	sux
gal-di	|GAL.DI|	𒃲𒁲	sux
galti	|GAL.DI|	𒃲𒁲	sux
dimgal	|GAL.DIM|	𒃲𒁴	sux
cidimgalx	|GAL.DIM₂|	𒃲𒁶	sux
nijirgalx	|GAL.DUN₃@g@g|	𒃲𒂇	sux
kindagal	|GAL.GAD&GAD.GAR&GAR|	𒃳	sux
kindajal	|GAL.GAD&GAD.GAR&GAR|	𒃳	sux
azlaggalx	|GAL.GIŠ.TUG₂.TE.A.DU|	𒃲𒄑𒌆𒋼𒀀𒁺	sux
sukkalgalx	|GAL.LUH|	𒃲𒈛	sux
nagargalx	|GAL.NAGAR|	𒃲𒉄	sux
santan	|GAL.NI|	𒃲𒉌	sux
santana	|GAL.NI|	𒃲𒉌	sux
candan	|GAL.NI|	𒃲𒉌	sux
candana	|GAL.NI|	𒃲𒉌	sux
ukra	|GAL.ŠUBUR|	𒃲𒋚	sux
ukur2	|GAL.ŠUBUR|	𒃲𒋚	sux
tiru	|GAL.TE|	𒃲𒋼	sux
tirum	|GAL.TE|	𒃲𒋼	sux
gallagalx	|GAL.TE.LAL|	𒃲𒋼𒇲	sux
simuggalx	|GAL.UMUM|	𒃲𒌣	sux
kindagal2	|GAL.URI|	𒃲𒌵	sux
kingal	|GAL.URU×BAR|	𒃲𒌺	sux
erictix	|GAL.ZU|	𒃲𒍪	sux
gagazu	|GAL.ZU|	𒃲𒍪	sux
gal-zu	|GAL.ZU|	𒃲𒍪	sux
LAK352	GALAM	𒃴	sux
gax	GALAM	𒃴	sux
galam	GALAM	𒃴	sux
gud5	GALAM	𒃴	sux
sukud	GALAM	𒃴	sux
sukux	GALAM	𒃴	sux
ubi	GALAM	𒃴	sux
gagalam	|GALAM.GALAM|	𒃴𒃴	sux
gibil5	|GALAM.GALAM|	𒃴𒃴	sux
LAK180	GAM	𒃵	sux
ar5	GAM	𒃵	sux
gam	GAM	𒃵	sux
gan7	GAM	𒃵	sux
girum	GAM	𒃵	sux
gum4	GAM	𒃵	sux
gur2	GAM	𒃵	sux
guru2	GAM	𒃵	sux
gurum	GAM	𒃵	sux
qam	GAM	𒃵	sux
qur3	GAM	𒃵	sux
gigirum	|GAM.GAM|	𒃵𒃵	sux
LAK644	GAN	𒃶	sux
gam4	GAN	𒃶	sux
gan	GAN	𒃶	sux
gana	GAN	𒃶	sux
he2	GAN	𒃶	sux
hi2	GAN	𒃶	sux
kan	GAN	𒃶	sux
kana	GAN	𒃶	sux
li6	GAN	𒃶	sux
qan	GAN	𒃶	sux
sag7	GAN	𒃶	sux
seg16	GAN	𒃶	sux
sig16	GAN	𒃶	sux
LAK89	GAN₂	𒃷	sux
eqlu	GAN₂	𒃷	sux
al3	GAN₂	𒃷	sux
alalx	GAN₂	𒃷	sux
aca5	GAN₂	𒃷	sux
acag	GAN₂	𒃷	sux
burux	GAN₂	𒃷	sux
ga3	GAN₂	𒃷	sux
gan2	GAN₂	𒃷	sux
gana2	GAN₂	𒃷	sux
ja3	GAN₂	𒃷	sux
girrix	GAN₂	𒃷	sux
iku	GAN₂	𒃷	sux
ichuru3	GAN₂	𒃷	sux
ichurum3	GAN₂	𒃷	sux
kalax	GAN₂	𒃷	sux
kan2	GAN₂	𒃷	sux
kana2	GAN₂	𒃷	sux
karx	GAN₂	𒃷	sux
mulu4	GAN₂	𒃷	sux
ul8	GAN₂	𒃷	sux
ululx	GAN₂	𒃷	sux
mulu4	|GAN₂.BU|	𒃷𒁍	sux
mulu4-bu	|GAN₂.BU|	𒃷𒁍	sux
canna	|GAN₂.BU|	𒃷𒁍	sux
lirumx	|GAN₂&GAN₂|	𒃹	sux
alal4	|GAN₂%GAN₂|	𒃺	sux
girrix	|GAN₂%GAN₂|	𒃺	sux
ulul2	|GAN₂%GAN₂|	𒃺	sux
LAK186	GAN₂@t	𒃸	sux
gar19	GAN₂@t	𒃸	sux
garak	GAN₂@t	𒃸	sux
gur6	GAN₂@t	𒃸	sux
guru6	GAN₂@t	𒃸	sux
ilx	GAN₂@t	𒃸	sux
kar2	GAN₂@t	𒃸	sux
kara2	GAN₂@t	𒃸	sux
kiri2	GAN₂@t	𒃸	sux
gugru	|GAN₂@t.GAN₂@t|	𒃸𒃸	sux
LAK525	GAR	𒃻	sux
MZL859	GAR	𒃻	sux
ga4	GAR	𒃻	sux
gar	GAR	𒃻	sux
gara	GAR	𒃻	sux
garak5	GAR	𒃻	sux
jar	GAR	𒃻	sux
inda3	GAR	𒃻	sux
inta3	GAR	𒃻	sux
kar5	GAR	𒃻	sux
kux	GAR	𒃻	sux
mar3	GAR	𒃻	sux
menari	GAR	𒃻	sux
mu8	GAR	𒃻	sux
neq2	GAR	𒃻	sux
ni3	GAR	𒃻	sux
nig2	GAR	𒃻	sux
nigix	GAR	𒃻	sux
nij2	GAR	𒃻	sux
nik2	GAR	𒃻	sux
nim5	GAR	𒃻	sux
nin6	GAR	𒃻	sux
ninda	GAR	𒃻	sux
nindan	GAR	𒃻	sux
ninni3	GAR	𒃻	sux
niq2	GAR	𒃻	sux
niqix	GAR	𒃻	sux
nita4	GAR	𒃻	sux
qar3	GAR	𒃻	sux
qara3	GAR	𒃻	sux
sa15	GAR	𒃻	sux
ca2	GAR	𒃻	sux
cikin	GAR	𒃻	sux
cu7	GAR	𒃻	sux
gapi	|GAR.GA₂×(A.IGI)|	𒃻𒂺	sux
nisikix	|GAR.GAD.TAK₄.UR₂|	𒃻𒃰𒋺𒌫	sux
argab	|GAR.IB|	𒃻𒅁	sux
arkab	|GAR.IB|	𒃻𒅁	sux
irkab	|GAR.IB|	𒃻𒅁	sux
gidectax	|GAR.KINGUSILI.SILA₃|	𒃻𒑜𒋡	sux
kibsur	|GAR.LAGAB|	𒃻𒆸	sux
kibcur	|GAR.LAGAB|	𒃻𒆸	sux
gug3	|GAR.LU₃|	𒃻𒈖	sux
gugina	|GAR.LU₃|	𒃻𒈖	sux
ensix	|GAR.PA.TE.SI|	𒃻𒉺𒋼𒋛	sux
balla2	|GAR.SAG.IL₂.EZEN.SAL|	𒃻𒊕𒅍𒂡𒊩	sux
balla	|GAR.SAG.IL₂.EZEN.UŠ|	𒃻𒊕𒅍𒂡𒍑	sux
kadra2	|GAR.ŠA₃|	𒃻𒊮	sux
kadra	|GAR.ŠA₃.A|	𒃻𒊮𒀀	sux
kadri	|GAR.ŠA₃.A|	𒃻𒊮𒀀	sux
kadru	|GAR.ŠA₃.A|	𒃻𒊮𒀀	sux
kadra3	|GAR.ŠA₃×A|	𒃻𒊯	sux
kadri3	|GAR.ŠA₃×A|	𒃻𒊯	sux
kadru3	|GAR.ŠA₃×A|	𒃻𒊯	sux
gidectax	|GAR.ŠANABI.SILA₃|	𒃻𒑛𒋡	sux
uttuku	|GAR.ŠID|	𒃻𒋃	sux
utugx	|GAR.ŠID|	𒃻𒋃	sux
utuqx	|GAR.ŠID|	𒃻𒋃	sux
utuku	|GAR.ŠID|	𒃻𒋃	sux
immal3	|GAR.ŠU.DUGUD|	𒃻𒋗𒂂	sux
gidecta	|GAR.ŠUŠANA.SILA₃|	𒃻𒑚𒋡	sux
LAK161	GAR₃	𒃼	sux
gar3	GAR₃	𒃼	sux
gara3	GAR₃	𒃼	sux
jar3	GAR₃	𒃼	sux
kar3	GAR₃	𒃼	sux
qar	GAR₃	𒃼	sux
qer5	GAR₃	𒃼	sux
gacan	GAŠAN	𒃽	sux
ugun2	GAŠAN	𒃽	sux
ugunu2	GAŠAN	𒃽	sux
LAK629	GEŠTIN	𒃾	sux
gectin	GEŠTIN	𒃾	sux
gectin@d	GEŠTIN	𒃾	sux
gectina	GEŠTIN	𒃾	sux
jectin	GEŠTIN	𒃾	sux
jectina	GEŠTIN	𒃾	sux
/mutin/	GEŠTIN	𒃾	sux
LAK630	|GEŠTIN×KUR|	𒃿	sux
adar3	|GEŠTIN×KUR|	𒃿	sux
ildag4	|GEŠTIN×KUR|	𒃿	sux
LAK464	GI	𒄀	sux
MZL141	GI	𒄀	sux
ecca3	GI	𒄀	sux
ge	GI	𒄀	sux
gen6	GI	𒄀	sux
gi	GI	𒄀	sux
gin6	GI	𒄀	sux
gitag	GI	𒄀	sux
ke2	GI	𒄀	sux
ki2	GI	𒄀	sux
qan2	GI	𒄀	sux
qe3	GI	𒄀	sux
qi3	GI	𒄀	sux
seg17	GI	𒄀	sux
si22	GI	𒄀	sux
sig17	GI	𒄀	sux
sissix	GI	𒄀	sux
tar5	GI	𒄀	sux
taru5	GI	𒄀	sux
kilim3	|GI.KAK|	𒄀𒆕	sux
ama3	|GI.LU|	𒄀𒇻	sux
cutumx	|GI.NA.AB.NA.TUM|	𒄀𒈾𒀊𒈾𒌈	sux
cutum	|GI.NA.AB.U.GUD|	𒄀𒈾𒀊𒌋𒄞	sux
cutum2~a	|GI.NA.AB.TUM|	𒄀𒈾𒀊𒈾𒌈	sux
cutumx~b	|E₂.GI.NA.AB.U.GUD|	𒂍𒄀𒈾𒀊𒌋𒄞	sux
cutumx~c	|E₂.GI.NA.AB.TUM|	𒄀𒈾𒀊𒈾𒌈	sux
cutumx~d	|E₂.GI.NA.AB.HI|	𒂍𒄀𒈾𒀊𒄭	sux
cudug	|GI.PAD|	𒄀𒉻	sux
MZL105	|GI%GI|	𒄃	sux
LAK465	|GI%GI|	𒄃	sux
esir4	|GI%GI|	𒄃	sux
ge16	|GI%GI|	𒄃	sux
gel	|GI%GI|	𒄃	sux
gig3	|GI%GI|	𒄃	sux
gi16	|GI%GI|	𒄃	sux
gib	|GI%GI|	𒄃	sux
gil	|GI%GI|	𒄃	sux
gili	|GI%GI|	𒄃	sux
gilibx	|GI%GI|	𒄃	sux
gilim	|GI%GI|	𒄃	sux
gillim	|GI%GI|	𒄃	sux
kil2	|GI%GI|	𒄃	sux
kilim2	|GI%GI|	𒄃	sux
qil2	|GI%GI|	𒄃	sux
qili2	|GI%GI|	𒄃	sux
unu10	|GI%GI|	𒄃	sux
LAK466	GI₄	𒄄	sux
ga8	GI₄	𒄄	sux
gagri	GI₄	𒄄	sux
ge4	GI₄	𒄄	sux
gi4	GI₄	𒄄	sux
ki8	GI₄	𒄄	sux
qe4	GI₄	𒄄	sux
qi4	GI₄	𒄄	sux
LAK467	|GI₄&GI₄|	𒄅	sux
kilx	|GI₄&GI₄|	𒄅	sux
esir5	|GI₄%GI₄|	𒄆	sux
gigi	|GI₄%GI₄|	𒄆	sux
gedim	GIDIM	𒄇	sux
gidim	GIDIM	𒄇	sux
kitim	GIDIM	𒄇	sux
ge17	GIG	𒈪𒉭	sux
gi17	GIG	𒈪𒉭	sux
gib3	GIG	𒈪𒉭	sux
gig	GIG	𒈪𒉭	sux
kij	GIG	𒈪𒉭	sux
kik	GIG	𒈪𒉭	sux
qiq	GIG	𒈪𒉭	sux
simx	GIG	𒈪𒉭	sux
LAK6	GIR₂	𒄈	sux
MZL6	GIR₂	𒄈	sux
garx	GIR₂	𒄈	sux
gir2	GIR₂	𒄈	sux
giri2	GIR₂	𒄈	sux
jir2	GIR₂	𒄈	sux
jiri2	GIR₂	𒄈	sux
irx	GIR₂	𒄈	sux
mer3	GIR₂	𒄈	sux
meri3	GIR₂	𒄈	sux
mirix	GIR₂	𒄈	sux
patru	GIR₂	𒄈	sux
ukur	GIR₂	𒄈	sux
LAK7	GIR₂@g	𒄉	sux
MZL7	GIR₂@g	𒄉	sux
ad2	GIR₂@g	𒄉	sux
adda4	GIR₂@g	𒄉	sux
addu3	GIR₂@g	𒄉	sux
at2	GIR₂@g	𒄉	sux
at2	GIR₂@g	𒄉	sux
kica2	GIR₂@g	𒄉	sux
kiceg2	GIR₂@g	𒄉	sux
kici17	GIR₂@g	𒄉	sux
kicig2	GIR₂@g	𒄉	sux
kicik2	GIR₂@g	𒄉	sux
tab2	GIR₂@g	𒄉	sux
ul4	GIR₂@g	𒄉	sux
LAK248	GIR₃	𒄊	sux
ance2	GIR₃	𒄊	sux
ancu2	GIR₃	𒄊	sux
er9	GIR₃	𒄊	sux
ger3	GIR₃	𒄊	sux
gir3	GIR₃	𒄊	sux
giri3	GIR₃	𒄊	sux
giru3	GIR₃	𒄊	sux
jir3	GIR₃	𒄊	sux
jiri3	GIR₃	𒄊	sux
huc2	GIR₃	𒄊	sux
imerix	GIR₃	𒄊	sux
ir9	GIR₃	𒄊	sux
kir10	GIR₃	𒄊	sux
kiri5	GIR₃	𒄊	sux
merx	GIR₃	𒄊	sux
mirix	GIR₃	𒄊	sux
qir7	GIR₃	𒄊	sux
sakkan	GIR₃	𒄊	sux
sumugan	GIR₃	𒄊	sux
sumugga	GIR₃	𒄊	sux
sumukan	GIR₃	𒄊	sux
sumuqan	GIR₃	𒄊	sux
cakan2	GIR₃	𒄊	sux
cakkan2	GIR₃	𒄊	sux
wir	GIR₃	𒄊	sux
caggin	|GIR₃.ARAD|	𒄊𒀴	sux
caggina	|GIR₃.ARAD|	𒄊𒀴	sux
cagina	|GIR₃.ARAD|	𒄊𒀴	sux
cakan6	|GIR₃.ARAD|	𒄊𒀴	sux
cakkana	|GIR₃.ARAD|	𒄊𒀴	sux
kicer	|GIR₃.BAR|	𒄊𒁇	sux
cer11	|GIR₃.BAR|	𒄊𒁇	sux
sakkan2	|GIR₃.GA₂×PA.A.AN|	𒄊𒃢𒀀𒀭	sux
hubud	|GIR₃.ŠU.IG|	𒄊𒋗𒅅	sux
girx	|GIR₃.ZA@t|	𒄊𒍞	sux
irgi	|GIR₃.ZA@t|	𒄊𒍞	sux
alim	|GIR₃×(A.IGI)|	𒄋	sux
alima	|GIR₃×(A.IGI)|	𒄋	sux
LAK251	|GIR₃×GAN₂@t|	𒄌	sux
gir16	|GIR₃×GAN₂@t|	𒄌	sux
giri16	|GIR₃×GAN₂@t|	𒄌	sux
girid2	|GIR₃×GAN₂@t|	𒄌	sux
jiri16	|GIR₃×GAN₂@t|	𒄌	sux
irx	|GIR₃×GAN₂@t|	𒄌	sux
LAK249	|GIR₃×IGI|	𒄍	sux
alimx	|GIR₃×IGI|	𒄍	sux
lulim	|GIR₃×(LU.IGI)|	𒄎	sux
lulima	|GIR₃×(LU.IGI)|	𒄎	sux
LAK255	|GIR₃×PA|	𒄏	sux
ance	|GIR₃×PA|	𒄏	sux
LAK589	GISAL	𒄐	sux
biz2	GISAL	𒄐	sux
gisal	GISAL	𒄐	sux
gical	GISAL	𒄐	sux
gizal	GISAL	𒄐	sux
jizzal	GISAL	𒄐	sux
jisal	GISAL	𒄐	sux
jizal	GISAL	𒄐	sux
mizal	GISAL	𒄐	sux
LAK673	GIŠ	𒄑	sux
is,u	GIŠ	𒄑	sux
es	GIŠ	𒄑	sux
ec19	GIŠ	𒄑	sux
es,	GIŠ	𒄑	sux
ez	GIŠ	𒄑	sux
gec	GIŠ	𒄑	sux
gez	GIŠ	𒄑	sux
gis	GIŠ	𒄑	sux
gic	GIŠ	𒄑	sux
gica	GIŠ	𒄑	sux
gis,	GIŠ	𒄑	sux
giz	GIŠ	𒄑	sux
jec	GIŠ	𒄑	sux
jic	GIŠ	𒄑	sux
jizzalx	GIŠ	𒄑	sux
is	GIŠ	𒄑	sux
ic6	GIŠ	𒄑	sux
is,	GIŠ	𒄑	sux
iz	GIŠ	𒄑	sux
kis2	GIŠ	𒄑	sux
mic3	GIŠ	𒄑	sux
mu9	GIŠ	𒄑	sux
nis2	GIŠ	𒄑	sux
nec2	GIŠ	𒄑	sux
nic2	GIŠ	𒄑	sux
micsun	|GIŠ.BAD|	𒄑𒁁	sux
gira2	|GIŠ.BAR|	𒄑𒁇	sux
gec-tin	|GIŠ.DIN|	𒄑𒁷	sux
wi5	|GIŠ.DIN|	𒄑𒁷	sux
gilgames	|GIŠ.DUN₃@g.MAŠ|	𒄑𒂆𒈦	sux
gilgamec	|GIŠ.DUN₃@g.MAŠ|	𒄑𒂆𒈦	sux
nisikix	|GIŠ.GAR.UMBIN|	𒄑𒃻𒌢	sux
kajeckarax	|GIŠ.KA.KAD₄|	𒄑𒅗𒆒	sux
kajeckarax	|GIŠ.KA.KAD₅|	𒄑𒅗𒆓	sux
gecbunx	|GIŠ.KI.BI|	𒄑𒆠𒁉	sux
jectukul2	|GIŠ.KU|	𒄑𒆪	sux
[...]	|GIŠ.KUL|	𒄑𒆰	sux
kulx	|GIŠ.KUL|	𒄑𒆰	sux
umma	|GIŠ.KUŠU₂|	𒄑𒆵	sux
ummenx	|GIŠ.KUŠU₂|	𒄑𒆵	sux
ummix	|GIŠ.KUŠU₂|	𒄑𒆵	sux
girix	|GIŠ.LU₂|	𒄑𒇽	sux
jecgirix	|GIŠ.LU₂|	𒄑𒇽	sux
amra	|GIŠ.MA₂.RA|	𒄑𒈣𒊏	sux
dimmucx	|GIŠ.MI|	𒄑𒈪	sux
gissu	|GIŠ.MI|	𒄑𒈪	sux
gizzu	|GIŠ.MI|	𒄑𒈪	sux
jissu	|GIŠ.MI|	𒄑𒈪	sux
luhumx	|GIŠ.MI|	𒄑𒈪	sux
luhummu	|GIŠ.MI|	𒄑𒈪	sux
s,il4	|GIŠ.MI|	𒄑𒈪	sux
ubilla2	|GIŠ.MI|	𒄑𒈪	sux
bil4	|GIŠ.NE|	𒄑𒉈	sux
pil4	|GIŠ.NE|	𒄑𒉈	sux
gilgames3	|GIŠ.NE.GA.MES|	𒄑𒉈𒂵𒈩	sux
gilgamec3	|GIŠ.NE.GA.MES|	𒄑𒉈𒂵𒈩	sux
bil3	|GIŠ.NE@s|	𒄑𒉋	sux
gibilx	|GIŠ.NE@s|	𒄑𒉋	sux
pil3	|GIŠ.NE@s|	𒄑𒉋	sux
cegx	|GIŠ.NE@s|	𒄑𒉋	sux
ubilla	|GIŠ.NE@s|	𒄑𒉋	sux
gilgamec2	|GIŠ.NE@s.GA.ME.U.U.U|	𒄑𒉋𒂵𒈨𒌋𒌋𒌋	sux
v+	|GIŠ.NI|	𒄑𒉌	sux
jec-nu11	|GIŠ.NU₁₁|	𒄑𒉢	sux
gecdu3	|GIŠ.PI.TUG₂|	𒄑𒉿𒌆	sux
gectu3	|GIŠ.PI.TUG₂|	𒄑𒉿𒌆	sux
gectug3	|GIŠ.PI.TUG₂|	𒄑𒉿𒌆	sux
jectu3	|GIŠ.PI.TUG₂|	𒄑𒉿𒌆	sux
jectug3	|GIŠ.PI.TUG₂|	𒄑𒉿𒌆	sux
gicdu3	|GIŠ.PI.TUG₂|	𒄑𒉿𒌆	sux
gictu3	|GIŠ.PI.TUG₂|	𒄑𒉿𒌆	sux
gictug3	|GIŠ.PI.TUG₂|	𒄑𒉿𒌆	sux
jictu3	|GIŠ.PI.TUG₂|	𒄑𒉿𒌆	sux
jictug3	|GIŠ.PI.TUG₂|	𒄑𒉿𒌆	sux
gecbux	|GIŠ.RU|	𒄑𒊒	sux
gecpax	|GIŠ.RU|	𒄑𒊒	sux
gecpux	|GIŠ.RU|	𒄑𒊒	sux
jecbux	|GIŠ.RU|	𒄑𒊒	sux
jecpax	|GIŠ.RU|	𒄑𒊒	sux
jecpux	|GIŠ.RU|	𒄑𒊒	sux
ummax	|GIŠ.SAL.KUR|	𒄑𒊩𒆳	sux
girix	|GIŠ.ŠU.LU₂|	𒄑𒋗𒇽	sux
michac	|GIŠ.TAR|	𒄑𒋻	sux
gecdu2	|GIŠ.TUG₂.PI|	𒄑𒌆𒉿	sux
gectu2	|GIŠ.TUG₂.PI|	𒄑𒌆𒉿	sux
gectug2	|GIŠ.TUG₂.PI|	𒄑𒌆𒉿	sux
jectug2	|GIŠ.TUG₂.PI|	𒄑𒌆𒉿	sux
jectu2	|GIŠ.TUG₂.PI|	𒄑𒌆𒉿	sux
gicdu2	|GIŠ.TUG₂.PI|	𒄑𒌆𒉿	sux
gictu2	|GIŠ.TUG₂.PI|	𒄑𒌆𒉿	sux
gictug2	|GIŠ.TUG₂.PI|	𒄑𒌆𒉿	sux
jictug2	|GIŠ.TUG₂.PI|	𒄑𒌆𒉿	sux
jictu2	|GIŠ.TUG₂.PI|	𒄑𒌆𒉿	sux
jizzalx	|GIŠ.TUG₂.PI.ŠIR@t.NUN|	𒄑𒌆𒉿𒋔𒉣	sux
jizzal2	|ŠIR@t.SILA₃|	𒋔𒋡	sux
aclag5	|GIŠ.TUG₂.PI.TE.A|	𒄑𒌆𒉿𒋼𒀀	sux
azalag5	|GIŠ.TUG₂.PI.TE.A|	𒄑𒌆𒉿𒋼𒀀	sux
azlag5	|GIŠ.TUG₂.PI.TE.A|	𒄑𒌆𒉿𒋼𒀀	sux
aclag3	|GIŠ.TUG₂.PI.TE.A.DU|	𒄑𒌆𒉿𒋼𒀀𒁺	sux
azalag3	|GIŠ.TUG₂.PI.TE.A.DU|	𒄑𒌆𒉿𒋼𒀀𒁺	sux
azlag3	|GIŠ.TUG₂.PI.TE.A.DU|	𒄑𒌆𒉿𒋼𒀀𒁺	sux
aclag6	|GIŠ.TUG₂.TE.A|	𒄑𒌆𒋼𒀀	sux
azalag6	|GIŠ.TUG₂.TE.A|	𒄑𒌆𒋼𒀀	sux
azlag6	|GIŠ.TUG₂.TE.A|	𒄑𒌆𒋼𒀀	sux
aclag4	|GIŠ.TUG₂.TE.A.DU|	𒄑𒌆𒋼𒀀𒁺	sux
azalag4	|GIŠ.TUG₂.TE.A.DU|	𒄑𒌆𒋼𒀀𒁺	sux
azlag4	|GIŠ.TUG₂.TE.A.DU|	𒄑𒌆𒋼𒀀𒁺	sux
gechar	|GIŠ×BAD|	𒄓	sux
gichar	|GIŠ×BAD|	𒄓	sux
ziz4	|GIŠ×BAD|	𒄓	sux
ezinux	|GIŠ×TAK₄|	𒄔	sux
qicatx	|GIŠ×TAK₄|	𒄔	sux
cabux	|GIŠ×TAK₄|	𒄔	sux
cex	|GIŠ×TAK₄|	𒄔	sux
terx	|GIŠ×TAK₄|	𒄔	sux
tirx	|GIŠ×TAK₄|	𒄔	sux
LAK610?	|GIŠ%GIŠ|	𒄒	sux
adamin3	|GIŠ%GIŠ|	𒄒	sux
adamen3	|GIŠ%GIŠ|	𒄒	sux
puhrum	|GIŠ%GIŠ|	𒄒	sux
alal3	|GIŠ%GIŠ|	𒄒	sux
an2	|GIŠ%GIŠ|	𒄒	sux
dara5	|GIŠ%GIŠ|	𒄒	sux
dari5	|GIŠ%GIŠ|	𒄒	sux
daru5	|GIŠ%GIŠ|	𒄒	sux
dur4	|GIŠ%GIŠ|	𒄒	sux
duru4	|GIŠ%GIŠ|	𒄒	sux
durum4	|GIŠ%GIŠ|	𒄒	sux
hul3	|GIŠ%GIŠ|	𒄒	sux
kib	|GIŠ%GIŠ|	𒄒	sux
kip	|GIŠ%GIŠ|	𒄒	sux
gib2	|GIŠ%GIŠ|	𒄒	sux
gip2	|GIŠ%GIŠ|	𒄒	sux
girrix	|GIŠ%GIŠ|	𒄒	sux
liri3	|GIŠ%GIŠ|	𒄒	sux
liru3	|GIŠ%GIŠ|	𒄒	sux
lirum3	|GIŠ%GIŠ|	𒄒	sux
qeb	|GIŠ%GIŠ|	𒄒	sux
qep	|GIŠ%GIŠ|	𒄒	sux
qib	|GIŠ%GIŠ|	𒄒	sux
qip	|GIŠ%GIŠ|	𒄒	sux
callur	|GIŠ%GIŠ|	𒄒	sux
cennur	|GIŠ%GIŠ|	𒄒	sux
tur4	|GIŠ%GIŠ|	𒄒	sux
tur4	|GIŠ%GIŠ|	𒄒	sux
ul3	|GIŠ%GIŠ|	𒄒	sux
ulul	|GIŠ%GIŠ|	𒄒	sux
lirumx	|GIŠ%GIŠ.ZA|	𒄒𒍝	sux
gur17	GIŠ@t	𒄕	sux
guru17	GIŠ@t	𒄕	sux
kana7	GIŠ@t	𒄕	sux
LAK509	GU	𒄖	sux
gu	GU	𒄖	sux
gumx	GU	𒄖	sux
ku8	GU	𒄖	sux
qu3	GU	𒄖	sux
LAK510	|GU%GU|	𒄗	sux
sax	|GU%GU|	𒄗	sux
sah4	|GU%GU|	𒄗	sux
sih5	|GU%GU|	𒄗	sux
suh3	|GU%GU|	𒄗	sux
zax	|GU%GU|	𒄗	sux
zih	|GU%GU|	𒄗	sux
sishe	|GU%GU.GU%GU|	𒄗𒄗	sux
LAK544	GU₂	𒄘	sux
kicādu	GU₂	𒄘	sux
gu2	GU₂	𒄘	sux
gun2	GU₂	𒄘	sux
lil6	GU₂	𒄘	sux
qu6	GU₂	𒄘	sux
tek	GU₂	𒄘	sux
tik	GU₂	𒄘	sux
tiq	GU₂	𒄘	sux
usanx	GU₂	𒄘	sux
LAK63	|GU₂.GAR₃|	𒄘𒃼	sux
KWU689	|GU₂.GAR₃|	𒄘𒃼	sux
aBZL87	|GU₂.GAR₃|	𒄘𒃼	sux
idigna	|GU₂.GAR₃|	𒄘𒃼	sux
dallax	|GU₂.GAR₃|	𒄘𒃼	sux
LAK557	|GU₂.NUNUZ|	𒄘𒉭	sux
nida	|GU₂.NUNUZ|	𒄘𒉭	sux
biltu	|GU₂.UN|	𒄘𒌦	sux
gun	|GU₂.UN|	𒄘𒌦	sux
LAK549	|GU₂×KAK|	𒄙	sux
dur	|GU₂×KAK|	𒄙	sux
tur2	|GU₂×KAK|	𒄙	sux
tur	|GU₂×KAK|	𒄙	sux
usanx	|GU₂×KAK|	𒄙	sux
duran	|GU₂×KAK.GIŠ%GIŠ|	𒄙𒄒	sux
turan	|GU₂×KAK.GIŠ%GIŠ|	𒄙𒄒	sux
ugurx	|GU₂×KAK×IGI@g|	𒄚	sux
munsub3	|GU₂×NUN|	𒄛	sux
musub3	|GU₂×NUN|	𒄛	sux
sub3	|GU₂×NUN|	𒄛	sux
usan	|GU₂×NUN|	𒄛	sux
usian	|GU₂×NUN|	𒄛	sux
ucen	|GU₂×NUN|	𒄛	sux
guerici	|GU₂×(SAL.TUG₂)|	𒄜	sux
LAK556	GU₂@g	𒄝	sux
mudx	GU₂@g	𒄝	sux
munsub4	GU₂@g	𒄝	sux
musub4	GU₂@g	𒄝	sux
usax	GU₂@g	𒄝	sux
usan2	GU₂@g	𒄝	sux
LAK123	GUD	𒄞	sux
alpu	GUD	𒄞	sux
alap	GUD	𒄞	sux
bahar	GUD	𒄞	sux
dapar	GUD	𒄞	sux
dapara	GUD	𒄞	sux
dipar	GUD	𒄞	sux
ectub	GUD	𒄞	sux
gadma	GUD	𒄞	sux
gar4	GUD	𒄞	sux
gara4	GUD	𒄞	sux
gidim7	GUD	𒄞	sux
gu4	GUD	𒄞	sux
gud	GUD	𒄞	sux
gudma	GUD	𒄞	sux
gudu	GUD	𒄞	sux
gugarid	GUD	𒄞	sux
gurx	GUD	𒄞	sux
har2	GUD	𒄞	sux
hara2	GUD	𒄞	sux
kamuc	GUD	𒄞	sux
ku15	GUD	𒄞	sux
kucdim	GUD	𒄞	sux
kucgim	GUD	𒄞	sux
kucum3	GUD	𒄞	sux
lagabx	GUD	𒄞	sux
qadma	GUD	𒄞	sux
qudmax	GUD	𒄞	sux
rucban	GUD	𒄞	sux
rucpan	GUD	𒄞	sux
cucgim	GUD	𒄞	sux
zeb3	GUD	𒄞	sux
zib3	GUD	𒄞	sux
lium	|GUD.AN.NA|	𒄞𒀭𒈾	sux
ildag2	|GUD×(A.KUR)|	𒄟	sux
LAK124	|GUD×KUR|	𒄠	sux
adar2	|GUD×KUR|	𒄠	sux
am	|GUD×KUR|	𒄠	sux
ama2	|GUD×KUR|	𒄠	sux
ildag3	|GUD×KUR|	𒄠	sux
MZL	|GUD&GUD.LUGAL|	𒄡	sux
biceba3	|GUD&GUD.LUGAL|	𒄡	sux
bicebi3	|GUD&GUD.LUGAL|	𒄡	sux
kacceba3	|GUD&GUD.LUGAL|	𒄡	sux
kaccebi3	|GUD&GUD.LUGAL|	𒄡	sux
LAK389	GUL	𒄢	sux
gul	GUL	𒄢	sux
gulu	GUL	𒄢	sux
isi2	GUL	𒄢	sux
isim2	GUL	𒄢	sux
isimu2	GUL	𒄢	sux
kul2	GUL	𒄢	sux
qul2	GUL	𒄢	sux
si23	GUL	𒄢	sux
sumun2	GUL	𒄢	sux
sumuna2	GUL	𒄢	sux
sumunu2	GUL	𒄢	sux
sun2	GUL	𒄢	sux
suna2	GUL	𒄢	sux
cun3	GUL	𒄢	sux
LAK633	GUM	𒄣	sux
gas2	GUM	𒄣	sux
gaz2	GUM	𒄣	sux
gu8	GUM	𒄣	sux
gum	GUM	𒄣	sux
kas6	GUM	𒄣	sux
ku13	GUM	𒄣	sux
kum	GUM	𒄣	sux
kun3	GUM	𒄣	sux
naga4	GUM	𒄣	sux
naja4	GUM	𒄣	sux
qu	GUM	𒄣	sux
qum	GUM	𒄣	sux
ca9	GUM	𒄣	sux
caqu3	GUM	𒄣	sux
LAK634	|GUM×ŠE|	𒄤	sux
gas	|GUM×ŠE|	𒄤	sux
gas,	|GUM×ŠE|	𒄤	sux
gaz	|GUM×ŠE|	𒄤	sux
gaza	|GUM×ŠE|	𒄤	sux
kas3	|GUM×ŠE|	𒄤	sux
kac6	|GUM×ŠE|	𒄤	sux
kas,3	|GUM×ŠE|	𒄤	sux
kaz	|GUM×ŠE|	𒄤	sux
kumx	|GUM×ŠE|	𒄤	sux
naga3	|GUM×ŠE|	𒄤	sux
naja3	|GUM×ŠE|	𒄤	sux
LAK88	GUR	𒄥	sux
gur	GUR	𒄥	sux
gura	GUR	𒄥	sux
guru	GUR	𒄥	sux
kur3	GUR	𒄥	sux
qur	GUR	𒄥	sux
quru	GUR	𒄥	sux
tari	GUR	𒄥	sux
taru	GUR	𒄥	sux
gur7	GUR₇	𒄦	sux
guru7	GUR₇	𒄦	sux
kara6	GUR₇	𒄦	sux
kuru13	GUR₇	𒄦	sux
bur7	GURUN	𒄧	sux
buru7	GURUN	𒄧	sux
gurin	GURUN	𒄧	sux
guru20	GURUN	𒄧	sux
gurumx	GURUN	𒄧	sux
gurun	GURUN	𒄧	sux
kurrunx	GURUN	𒄧	sux
kurun6	GURUN	𒄧	sux
LAK709b	GURUŠ	𒄨	sux
girec2	GURUŠ	𒄨	sux
giric2	GURUŠ	𒄨	sux
guruc	GURUŠ	𒄨	sux
jerec2	GURUŠ	𒄨	sux
juruc	GURUŠ	𒄨	sux
murucx	GURUŠ	𒄨	sux
LAK351	HA	𒄩	sux
)a4	HA	𒄩	sux
a7	HA	𒄩	sux
ayax	HA	𒄩	sux
gir14	HA	𒄩	sux
ha	HA	𒄩	sux
kir9	HA	𒄩	sux
ku6	HA	𒄩	sux
kua	HA	𒄩	sux
pec11	HA	𒄩	sux
kuar	|HA.A|	𒄩𒀀	sux
kuara	|HA.A|	𒄩𒀀	sux
sah6	|HA.A|	𒄩𒀀	sux
saha6	|HA.A|	𒄩𒀀	sux
zah2	|HA.A|	𒄩𒀀	sux
zaha2	|HA.A|	𒄩𒀀	sux
dullux	|HA.NAGAR.BU|	𒄩𒉄𒁍	sux
enkux	|HA.ZAG|	𒄩𒍠	sux
LAK353	HA@g	𒄫	sux
bis2	HA@g	𒄫	sux
bic	HA@g	𒄫	sux
buc2	HA@g	𒄫	sux
ger	HA@g	𒄫	sux
gir	HA@g	𒄫	sux
giri	HA@g	𒄫	sux
jir	HA@g	𒄫	sux
jiri	HA@g	𒄫	sux
ha6	HA@g	𒄫	sux
kar4	HA@g	𒄫	sux
ker	HA@g	𒄫	sux
kir	HA@g	𒄫	sux
kiri	HA@g	𒄫	sux
pes	HA@g	𒄫	sux
pec	HA@g	𒄫	sux
pis	HA@g	𒄫	sux
pic	HA@g	𒄫	sux
pica	HA@g	𒄫	sux
pus	HA@g	𒄫	sux
puc3	HA@g	𒄫	sux
qer	HA@g	𒄫	sux
qir	HA@g	𒄫	sux
qiri	HA@g	𒄫	sux
cegx	HA@g	𒄫	sux
zubud	HA@t	𒄪	sux
zugud	HA@t	𒄪	sux
LAK5	HAL	𒄬	sux
MZL3	HAL	𒄬	sux
buluh	HAL	𒄬	sux
bur8	HAL	𒄬	sux
buru8	HAL	𒄬	sux
buruh	HAL	𒄬	sux
hal	HAL	𒄬	sux
hala	HAL	𒄬	sux
LAK359	HI	𒄭	sux
)i3	HI	𒄭	sux
da10	HI	𒄭	sux
dab3	HI	𒄭	sux
de8	HI	𒄭	sux
di2	HI	𒄭	sux
du10	HI	𒄭	sux
dub3	HI	𒄭	sux
dug3	HI	𒄭	sux
dugu	HI	𒄭	sux
ha4	HI	𒄭	sux
he	HI	𒄭	sux
hi	HI	𒄭	sux
i11	HI	𒄭	sux
kugu	HI	𒄭	sux
mux	HI	𒄭	sux
ta8	HI	𒄭	sux
te2	HI	𒄭	sux
ti2	HI	𒄭	sux
ta3	HI	𒄭	sux
tab6	HI	𒄭	sux
te2	HI	𒄭	sux
ti2	HI	𒄭	sux
LAK360	|HI.A|	𒄭𒀀	sux
ha2	|HI.A|	𒄭𒀀	sux
LAK240	|HI.GIR₃|	𒄭𒄊	sux
hic4	|HI.GIR₃|	𒄭𒄊	sux
huc	|HI.GIR₃|	𒄭𒄊	sux
huca	|HI.GIR₃|	𒄭𒄊	sux
hucux	|HI.GIR₃|	𒄭𒄊	sux
ruc	|HI.GIR₃|	𒄭𒄊	sux
LAK361	|HI×AŠ|	𒄮	sux
kaz8	|HI×AŠ|	𒄮	sux
kazaza	|HI×AŠ|	𒄮	sux
mul3	|HI×AŠ|	𒄮	sux
muc4	|HI×AŠ|	𒄮	sux
sur3	|HI×AŠ|	𒄮	sux
uc17	|HI×AŠ|	𒄮	sux
ucca	|HI×AŠ|	𒄮	sux
zinanutu	|HI×AŠ|	𒄮	sux
ziz3	|HI×AŠ|	𒄮	sux
LAK370	|HI×AŠ₂|	𒄯	sux
ar3	|HI×AŠ₂|	𒄯	sux
ara3	|HI×AŠ₂|	𒄯	sux
endibdim	|HI×AŠ₂|	𒄯	sux
ga11	|HI×AŠ₂|	𒄯	sux
gadibdim	|HI×AŠ₂|	𒄯	sux
gin8	|HI×AŠ₂|	𒄯	sux
gu13	|HI×AŠ₂|	𒄯	sux
gudibdim	|HI×AŠ₂|	𒄯	sux
gunux	|HI×AŠ₂|	𒄯	sux
gur14	|HI×AŠ₂|	𒄯	sux
har	|HI×AŠ₂|	𒄯	sux
hara	|HI×AŠ₂|	𒄯	sux
hir2	|HI×AŠ₂|	𒄯	sux
hu4	|HI×AŠ₂|	𒄯	sux
hur	|HI×AŠ₂|	𒄯	sux
huru	|HI×AŠ₂|	𒄯	sux
ir5	|HI×AŠ₂|	𒄯	sux
kikken	|HI×AŠ₂|	𒄯	sux
kikkin	|HI×AŠ₂|	𒄯	sux
ken2	|HI×AŠ₂|	𒄯	sux
kin2	|HI×AŠ₂|	𒄯	sux
kinkin	|HI×AŠ₂|	𒄯	sux
mar6	|HI×AŠ₂|	𒄯	sux
mur	|HI×AŠ₂|	𒄯	sux
muru	|HI×AŠ₂|	𒄯	sux
murum	|HI×AŠ₂|	𒄯	sux
sagbar	|HI×AŠ₂|	𒄯	sux
saggar2	|HI×AŠ₂|	𒄯	sux
sajjar2	|HI×AŠ₂|	𒄯	sux
surx	|HI×AŠ₂|	𒄯	sux
unux	|HI×AŠ₂|	𒄯	sux
ur5	|HI×AŠ₂|	𒄯	sux
ura5	|HI×AŠ₂|	𒄯	sux
urux	|HI×AŠ₂|	𒄯	sux
ur5-ca4	|HI×AŠ₂.DU|	𒄯𒁺	sux
urca	|HI×AŠ₂.DU|	𒄯𒁺	sux
LAK371	|HI×AŠ₂.HI×AŠ₂|	𒄯𒄯	sux
ara5	|HI×AŠ₂.HI×AŠ₂|	𒄯𒄯	sux
kikken2	|HI×AŠ₂.HI×AŠ₂|	𒄯𒄯	sux
kikkin2	|HI×AŠ₂.HI×AŠ₂|	𒄯𒄯	sux
kinkin2	|HI×AŠ₂.HI×AŠ₂|	𒄯𒄯	sux
ur5-gu7	|HI×AŠ₂.KA×GAR|	𒄯𒅥	sux
urgu	|HI×AŠ₂.KA×GAR|	𒄯𒅥	sux
azubir	|HI×AŠ₂.SAG|	𒄯𒊕	sux
azugna	|HI×AŠ₂.SAG|	𒄯𒊕	sux
azukna	|HI×AŠ₂.SAG|	𒄯𒊕	sux
LAK366	|HI×BAD|	𒄰	sux
du15	|HI×BAD|	𒄰	sux
eric6	|HI×BAD|	𒄰	sux
gam2	|HI×BAD|	𒄰	sux
gama2	|HI×BAD|	𒄰	sux
hud3	|HI×BAD|	𒄰	sux
ka13	|HI×BAD|	𒄰	sux
kam	|HI×BAD|	𒄰	sux
kama	|HI×BAD|	𒄰	sux
qam2	|HI×BAD|	𒄰	sux
tu7	|HI×BAD|	𒄰	sux
udul2	|HI×BAD|	𒄰	sux
utul2	|HI×BAD|	𒄰	sux
MZL595~v	KAM@v		sux
as6	|HI×DIŠ|	𒄱	sux
ac8	|HI×DIŠ|	𒄱	sux
cardic	|HI×DIŠ|	𒄱	sux
cargec	|HI×DIŠ|	𒄱	sux
umma2	|HI×DIŠ|	𒄱	sux
utulx	|HI×DIŠ|	𒄱	sux
sargad	|HI×GAD|	𒄲	sux
cargad	|HI×GAD|	𒄲	sux
cargadu	|HI×GAD|	𒄲	sux
gukin2	|HI×KIN|	𒄳	sux
LAK367	|HI×NUN|	𒄴	sux
a)2	|HI×NUN|	𒄴	sux
ah	|HI×NUN|	𒄴	sux
aha	|HI×NUN|	𒄴	sux
bi9	|HI×NUN|	𒄴	sux
duga3	|HI×NUN|	𒄴	sux
e)2	|HI×NUN|	𒄴	sux
eh	|HI×NUN|	𒄴	sux
giricx	|HI×NUN|	𒄴	sux
gudux	|HI×NUN|	𒄴	sux
i)2	|HI×NUN|	𒄴	sux
ih	|HI×NUN|	𒄴	sux
nu13	|HI×NUN|	𒄴	sux
numun3	|HI×NUN|	𒄴	sux
u13	|HI×NUN|	𒄴	sux
u)2	|HI×NUN|	𒄴	sux
uh	|HI×NUN|	𒄴	sux
uhu	|HI×NUN|	𒄴	sux
uman	|HI×NUN|	𒄴	sux
umun3	|HI×NUN|	𒄴	sux
uplux	|HI×NUN|	𒄴	sux
kici13	|HI×NUN.KASKAL|	𒄴𒆜	sux
LAK368	|HI×NUN.ME|	𒄴𒈨	sux
gudx	|HI×NUN.ME|	𒄴𒈨	sux
guda2	|HI×NUN.ME|	𒄴𒈨	sux
guddax	|HI×NUN.ME|	𒄴𒈨	sux
gudu4	|HI×NUN.ME|	𒄴𒈨	sux
gudug	|HI×NUN.ME|	𒄴𒈨	sux
cutug2	|HI×NUN.ME|	𒄴𒈨	sux
luhca	|HI×NUN.ME.U|	𒄴𒈨𒌋	sux
luhcu	|HI×NUN.ME.U|	𒄴𒈨𒌋	sux
ulu2	|HI×NUN.ME.U|	𒄴𒈨𒌋	sux
utul12	|HI×NUN.ME.U|	𒄴𒈨𒌋	sux
LAK372	|HI×ŠE|	𒄵	sux
ber	|HI×ŠE|	𒄵	sux
bir	|HI×ŠE|	𒄵	sux
biri	|HI×ŠE|	𒄵	sux
dubur	|HI×ŠE|	𒄵	sux
ellag2	|HI×ŠE|	𒄵	sux
ellaj2	|HI×ŠE|	𒄵	sux
ellamx	|HI×ŠE|	𒄵	sux
gerec	|HI×ŠE|	𒄵	sux
girec	|HI×ŠE|	𒄵	sux
giric	|HI×ŠE|	𒄵	sux
kalam2	|HI×ŠE|	𒄵	sux
pir3	|HI×ŠE|	𒄵	sux
urx	|HI×ŠE|	𒄵	sux
zanzana	|HI×ŠE|	𒄵	sux
dubur2	|HI×U|	𒄶	sux
caru	|HI×U|	𒄶	sux
car)u	|HI×U|	𒄶	sux
1(car)u)	|HI×U|	𒄶	sux
LAK64	HU	𒄷	sux
MZL132	HU	𒄷	sux
)u5	HU	𒄷	sux
bag	HU	𒄷	sux
bah	HU	𒄷	sux
bak	HU	𒄷	sux
baq	HU	𒄷	sux
burux	HU	𒄷	sux
dalx	HU	𒄷	sux
hu	HU	𒄷	sux
muc8	HU	𒄷	sux
mucen	HU	𒄷	sux
mucena	HU	𒄷	sux
pa7	HU	𒄷	sux
pag	HU	𒄷	sux
pah3	HU	𒄷	sux
pak	HU	𒄷	sux
paq	HU	𒄷	sux
puq2	HU	𒄷	sux
talx	HU	𒄷	sux
u11	HU	𒄷	sux
usan5	HU	𒄷	sux
LAK65	|HU.HI|	𒄷𒄭	sux
MZL137	|HU.HI|	𒄷𒄭	sux
mat3	|HU.HI|	𒄷𒄭	sux
mu12	|HU.HI|	𒄷𒄭	sux
mud	|HU.HI|	𒄷𒄭	sux
mut	|HU.HI|	𒄷𒄭	sux
mut	|HU.HI|	𒄷𒄭	sux
mutux	|HU.HI|	𒄷𒄭	sux
usanda	|HU.KAK|	𒄷𒆕	sux
usandu	|HU.KAK|	𒄷𒆕	sux
anzux	|HU.MI.AN.IM|	𒄷𒈪𒀭𒅎	sux
LAK68	|HU.NA₂|	𒄷𒈿	sux
MZL138	|HU.NA₂|	𒄷𒈿	sux
nax	|HU.NA₂|	𒄷𒈿	sux
nux	|HU.NA₂|	𒄷𒈿	sux
sa4	|HU.NA₂|	𒄷𒈿	sux
ca22	|HU.NA₂|	𒄷𒈿	sux
ce21	|HU.NA₂|	𒄷𒈿	sux
LAK66	|HU.SI|	𒄷𒋛	sux
MZL133	|HU.SI|	𒄷𒋛	sux
u5	|HU.SI|	𒄷𒋛	sux
ud3	|HU.SI|	𒄷𒋛	sux
dux	HUB₂	𒄸	sux
hub2	HUB₂	𒄸	sux
hup2	HUB₂	𒄸	sux
kup3	HUB₂	𒄸	sux
tu11	HUB₂	𒄸	sux
tukx	HUB₂	𒄸	sux
tumx	HUB₂	𒄸	sux
tun2	HUB₂	𒄸	sux
rig9	|HUB₂.DU|	𒄸𒁺	sux
LAK475	|HUB₂×AN|	𒄹	sux
LAK476	|HUB₂×UD|	𒄽	sux
hub	|HUB₂×UD|	𒄽	sux
hup	|HUB₂×UD|	𒄽	sux
qup2	|HUB₂×UD|	𒄽	sux
tu10	|HUB₂×UD|	𒄽	sux
tumx	|HUB₂×UD|	𒄽	sux
tun	|HUB₂×UD|	𒄽	sux
LAK183	HUL₂	𒄾	sux
bibra	HUL₂	𒄾	sux
bibri	HUL₂	𒄾	sux
guggal	HUL₂	𒄾	sux
gukkal	HUL₂	𒄾	sux
hul2	HUL₂	𒄾	sux
hula2	HUL₂	𒄾	sux
kungal	HUL₂	𒄾	sux
kuc8	HUL₂	𒄾	sux
ukuc2	HUL₂	𒄾	sux
LAK135	I	𒄿	sux
i	I	𒄿	sux
nat2	I	𒄿	sux
ia	|I.A|	𒅀	sux
ie	|I.A|	𒅀	sux
ii	|I.A|	𒅀	sux
iu	|I.A|	𒅀	sux
yi2	|I.A|	𒅀	sux
kun4	|I.LU|	𒄿𒇻	sux
kuj4	|I.LU|	𒄿𒇻	sux
arinax	|I.LU₂@s.NA|	𒄿𒈕𒈾	sux
LAK755	IB	𒅁	sux
arkabx	IB	𒅁	sux
dar2	IB	𒅁	sux
dara2	IB	𒅁	sux
dari2	IB	𒅁	sux
daru2	IB	𒅁	sux
darum2	IB	𒅁	sux
diri2	IB	𒅁	sux
eb	IB	𒅁	sux
ep	IB	𒅁	sux
ib	IB	𒅁	sux
ibbi	IB	𒅁	sux
ip	IB	𒅁	sux
urac	IB	𒅁	sux
urta	IB	𒅁	sux
LAK4	IDIM	𒅂	sux
MZL113b	IDIM	𒅂	sux
ari2	IDIM	𒅂	sux
banda4	IDIM	𒅂	sux
dehi4	IDIM	𒅂	sux
ece3	IDIM	𒅂	sux
hanic	IDIM	𒅂	sux
idim	IDIM	𒅂	sux
iri8	IDIM	𒅂	sux
kir5	IDIM	𒅂	sux
mid	IDIM	𒅂	sux
nagbu	IDIM	𒅂	sux
pax	IDIM	𒅂	sux
rapiqu2	IDIM	𒅂	sux
sullat	IDIM	𒅂	sux
cullat	IDIM	𒅂	sux
tehi4	IDIM	𒅂	sux
uri4	IDIM	𒅂	sux
urumx	IDIM	𒅂	sux
bansur2	|IDIM&IDIM.BUR|	𒅃	sux
bancur2	|IDIM&IDIM.BUR|	𒅃	sux
burx	|IDIM&IDIM.BUR|	𒅃	sux
buru9	|IDIM&IDIM.BUR|	𒅃	sux
gurinx	|IDIM&IDIM.BUR|	𒅃	sux
gurunx	|IDIM&IDIM.BUR|	𒅃	sux
kici11	|IDIM&IDIM.BUR|	𒅃	sux
kurunx	|IDIM&IDIM.BUR|	𒅃	sux
burx	|4×(IDIM&IDIM)|	𒅄	sux
burux	|4×(IDIM&IDIM)|	𒅄	sux
gurinx	|4×(IDIM&IDIM)|	𒅄	sux
gurunx	|4×(IDIM&IDIM)|	𒅄	sux
kurunx	|4×(IDIM&IDIM)|	𒅄	sux
LAK82	IG	𒅅	sux
MZL136	IG	𒅅	sux
da11	IG	𒅅	sux
eg	IG	𒅅	sux
ej	IG	𒅅	sux
ek	IG	𒅅	sux
eq	IG	𒅅	sux
ga7	IG	𒅅	sux
gagal	IG	𒅅	sux
gal2	IG	𒅅	sux
gala7	IG	𒅅	sux
jal2	IG	𒅅	sux
ig	IG	𒅅	sux
iga	IG	𒅅	sux
ik	IG	𒅅	sux
iq	IG	𒅅	sux
kagar	IG	𒅅	sux
/mal/	IG	𒅅	sux
mal3	IG	𒅅	sux
LAK421	IGI	𒅆	sux
mahru	IGI	𒅆	sux
panu	IGI	𒅆	sux
bad5	IGI	𒅆	sux
badi	IGI	𒅆	sux
bat5	IGI	𒅆	sux
damu2	IGI	𒅆	sux
ge8	IGI	𒅆	sux
gi8	IGI	𒅆	sux
igax	IGI	𒅆	sux
igi	IGI	𒅆	sux
igu	IGI	𒅆	sux
ina2	IGI	𒅆	sux
ini2	IGI	𒅆	sux
inu2	IGI	𒅆	sux
lam5	IGI	𒅆	sux
le3	IGI	𒅆	sux
lem	IGI	𒅆	sux
li3	IGI	𒅆	sux
lib4	IGI	𒅆	sux
lim	IGI	𒅆	sux
lima	IGI	𒅆	sux
limi	IGI	𒅆	sux
lum2	IGI	𒅆	sux
pa10	IGI	𒅆	sux
pad4	IGI	𒅆	sux
pan3	IGI	𒅆	sux
rax	IGI	𒅆	sux
si17	IGI	𒅆	sux
ce20	IGI	𒅆	sux
ci	IGI	𒅆	sux
ahhur	|IGI.A|	𒅆𒀀	sux
imhur4	|IGI.A|	𒅆𒀀	sux
uhhur3	|IGI.A|	𒅆𒀀	sux
imhur2	|IGI.BI|	𒅆𒁉	sux
uhhur	|IGI.BI|	𒅆𒁉	sux
igira	|IGI.BU|	𒅆𒁍	sux
ca17	|IGI.DIB|	𒅇	sux
u3	|IGI.DIB|	𒅇	sux
henzer	|IGI.DIM|	𒅆𒁴	sux
henzir	|IGI.DIM|	𒅆𒁴	sux
ubri2	|IGI.DIM|	𒅆𒁴	sux
acarid	|IGI.DU|	𒅆𒁺	sux
acaridu	|IGI.DU|	𒅆𒁺	sux
mahru	|IGI.DU|	𒅆𒁺	sux
gecdu4	|IGI.DU|	𒅆𒁺	sux
gectu4	|IGI.DU|	𒅆𒁺	sux
igectu	|IGI.DU|	𒅆𒁺	sux
igictu	|IGI.DU|	𒅆𒁺	sux
mahra	|IGI.DU|	𒅆𒁺	sux
palil	|IGI.DU|	𒅆𒁺	sux
LAK427	|IGI.DUB|	𒅆𒁾	sux
agrig	|IGI.DUB|	𒅆𒁾	sux
ajrig	|IGI.DUB|	𒅆𒁾	sux
geckim	|IGI.DUB|	𒅆𒁾	sux
jeckim	|IGI.DUB|	𒅆𒁾	sux
giskim	|IGI.DUB|	𒅆𒁾	sux
gickim	|IGI.DUB|	𒅆𒁾	sux
gizkim	|IGI.DUB|	𒅆𒁾	sux
jiskim	|IGI.DUB|	𒅆𒁾	sux
jickim	|IGI.DUB|	𒅆𒁾	sux
iskim	|IGI.DUB|	𒅆𒁾	sux
izkim	|IGI.DUB|	𒅆𒁾	sux
u6	|IGI.E₂|	𒅆𒂍	sux
ug6	|IGI.E₂|	𒅆𒂍	sux
burux	|IGI.ERIN₂|	𒅆𒂟	sux
burumx	|IGI.ERIN₂|	𒅆𒂟	sux
gurux	|IGI.ERIN₂|	𒅆𒂟	sux
gurum2	|IGI.ERIN₂|	𒅆𒂟	sux
kur7	|IGI.ERIN₂|	𒅆𒂟	sux
kuru7	|IGI.ERIN₂|	𒅆𒂟	sux
kurum7	|IGI.ERIN₂|	𒅆𒂟	sux
sa13	|IGI.ERIN₂|	𒅆𒂟	sux
sag10	|IGI.ERIN₂|	𒅆𒂟	sux
seg5	|IGI.ERIN₂|	𒅆𒂟	sux
sig5	|IGI.ERIN₂|	𒅆𒂟	sux
ca15	|IGI.ERIN₂|	𒅆𒂟	sux
LAK434	|IGI.EŠ₂|	𒅆𒂠	sux
libir	|IGI.EŠ₂|	𒅆𒂠	sux
si5	|IGI.EŠ₂|	𒅆𒂠	sux
gectux	|IGI.EŠ₂.DU|	𒅆𒂠𒁺	sux
ildu	|IGI.EŠ₂.DU.ERIN₂|	𒅆𒂠𒁺𒂟	sux
ildum	|IGI.EŠ₂.DU.ERIN₂|	𒅆𒂠𒁺𒂟	sux
ilduma	|IGI.EŠ₂.DU.ERIN₂|	𒅆𒂠𒁺𒂟	sux
ildumma	|IGI.EŠ₂.DU.ERIN₂|	𒅆𒂠𒁺𒂟	sux
palil2	|IGI.EŠ₂.DU.ERIN₂|	𒅆𒂠𒁺𒂟	sux
pallilx	|IGI.EŠ₂.DU.ERIN₂|	𒅆𒂠𒁺𒂟	sux
imhur3	|IGI.GA|	𒅆𒂵	sux
uhhur2	|IGI.GA|	𒅆𒂵	sux
LAK435	|IGI.GAR|	𒅆𒃻	sux
gurumx	|IGI.GAR|	𒅆𒃻	sux
dabda	|IGI.IGI|	𒅆𒅆	sux
lalla2	|IGI.IGI|	𒅆𒅆	sux
lelle	|IGI.IGI|	𒅆𒅆	sux
lelli	|IGI.IGI|	𒅆𒅆	sux
lilli	|IGI.IGI|	𒅆𒅆	sux
lilib	|IGI.IGI|	𒅆𒅆	sux
dala2	|IGI.KAK|	𒅆𒆕	sux
dalla2	|IGI.KAK|	𒅆𒆕	sux
henburx	|IGI.KAK|	𒅆𒆕	sux
cukur	|IGI.KAK|	𒅆𒆕	sux
ubri	|IGI.KAK|	𒅆𒆕	sux
ubrim	|IGI.KAK|	𒅆𒆕	sux
ganzer3	|IGI.KUR|	𒅆𒆳	sux
ganzir3	|IGI.KUR|	𒅆𒆳	sux
halib	|IGI.KUR|	𒅆𒆳	sux
hilib	|IGI.KUR|	𒅆𒆳	sux
...luku	|IGI.KUR|	𒅆𒆳	sux
ganzer	|IGI.KUR.ZA|	𒅆𒆳𒍝	sux
ganzir	|IGI.KUR.ZA|	𒅆𒆳𒍝	sux
ini4	|IGI.MIN|	𒅆𒈫	sux
īnuII	|IGI.MIN|	𒅆𒈫	sux
ildux	|IGI.NAGAR|	𒅆𒉄	sux
ildu2	|IGI.NAGAR.BU|	𒅆𒉄𒁍	sux
ildum2	|IGI.NAGAR.BU|	𒅆𒉄𒁍	sux
ilduma2	|IGI.NAGAR.BU|	𒅆𒉄𒁍	sux
ildumma2	|IGI.NAGAR.BU|	𒅆𒉄𒁍	sux
LAK422	|IGI.RI|	𒅈	sux
ar	|IGI.RI|	𒅈	sux
ara8	|IGI.RI|	𒅈	sux
LAK423	|IGI.RU|	𒅆𒊒	sux
pa3	|IGI.RU|	𒅆𒊒	sux
pad3	|IGI.RU|	𒅆𒊒	sux
ligim	|IGI.TUR.TUR|	𒅆𒌉𒌉	sux
ligima	|IGI.TUR.TUR|	𒅆𒌉𒌉	sux
ligin	|IGI.TUR.TUR|	𒅆𒌉𒌉	sux
LAK428	|IGI.UR|	𒅆𒌨	sux
hul	|IGI.UR|	𒅆𒌨	sux
hula	|IGI.UR|	𒅆𒌨	sux
hulu	|IGI.UR|	𒅆𒌨	sux
hulpad	|IGI.UR.RU.GAR|	𒅆𒌨𒊒𒃻	sux
hul4	|IGI.UR@s|	𒅆𒌪	sux
agrigx	|IGI.ZI|	𒅆𒍣	sux
dimsar	|IGI&IGI.ŠIR&ŠIR.UD&UD|	𒅉	sux
LAK437	IGI@g	𒅊	sux
agar4	IGI@g	𒅊	sux
igi2	IGI@g	𒅊	sux
igigunux	IGI@g	𒅊	sux
imma3	IGI@g	𒅊	sux
nab4	IGI@g	𒅊	sux
nam4	IGI@g	𒅊	sux
sa7	IGI@g	𒅊	sux
sag12	IGI@g	𒅊	sux
samag6	IGI@g	𒅊	sux
se12	IGI@g	𒅊	sux
seg7	IGI@g	𒅊	sux
si12	IGI@g	𒅊	sux
sig7	IGI@g	𒅊	sux
camagx	IGI@g	𒅊	sux
cex	IGI@g	𒅊	sux
ci7	IGI@g	𒅊	sux
ugur2	IGI@g	𒅊	sux
ukur5	IGI@g	𒅊	sux
zix	IGI@g	𒅊	sux
sa7-alan	|IGI@g.ALAN|	𒅊𒀩	sux
salamx	|IGI@g.ALAN|	𒅊𒀩	sux
ukdin	|IGI@g.ALAN|	𒅊𒀩	sux
uktin	|IGI@g.ALAN|	𒅊𒀩	sux
uludim2	|IGI@g.ALAN|	𒅊𒀩	sux
uludin2	|IGI@g.ALAN|	𒅊𒀩	sux
ulutim2	|IGI@g.ALAN|	𒅊𒀩	sux
ulutin2	|IGI@g.ALAN|	𒅊𒀩	sux
sermuccu	|IGI@g.TAK₄.ALAN|	𒅊𒋺𒀩	sux
sirmuccu	|IGI@g.TAK₄.ALAN|	𒅊𒋺𒀩	sux
zermucku	|IGI@g.TAK₄.ALAN|	𒅊𒋺𒀩	sux
zermuccu	|IGI@g.TAK₄.ALAN|	𒅊𒋺𒀩	sux
zirmuccu	|IGI@g.TAK₄.ALAN|	𒅊𒋺𒀩	sux
LAK502	IL	𒅋	sux
al9	IL	𒅋	sux
el2	IL	𒅋	sux
il	IL	𒅋	sux
el4	|IL×GAN₂@t|	𒅌	sux
il8	|IL×GAN₂@t|	𒅌	sux
LAK172?	IL₂	𒅍	sux
dubsik	IL₂	𒅍	sux
dupsik	IL₂	𒅍	sux
dusi	IL₂	𒅍	sux
dussu	IL₂	𒅍	sux
dusu	IL₂	𒅍	sux
ga6	IL₂	𒅍	sux
gil3	IL₂	𒅍	sux
gur3	IL₂	𒅍	sux
guru3	IL₂	𒅍	sux
ja6	IL₂	𒅍	sux
il2	IL₂	𒅍	sux
ila2	IL₂	𒅍	sux
ili2	IL₂	𒅍	sux
LAK376	IM	𒅎	sux
adad	IM	𒅎	sux
anegi	IM	𒅎	sux
di[...]ig	IM	𒅎	sux
did	IM	𒅎	sux
dalhamunx	IM	𒅎	sux
em	IM	𒅎	sux
enegi	IM	𒅎	sux
enegir	IM	𒅎	sux
ennegi	IM	𒅎	sux
ennigi	IM	𒅎	sux
ilumer	IM	𒅎	sux
im	IM	𒅎	sux
imex	IM	𒅎	sux
imi	IM	𒅎	sux
icgurx	IM	𒅎	sux
ickur	IM	𒅎	sux
kakra	IM	𒅎	sux
kakru	IM	𒅎	sux
karkar	IM	𒅎	sux
karkara	IM	𒅎	sux
mer2	IM	𒅎	sux
mir2	IM	𒅎	sux
mur3	IM	𒅎	sux
murim	IM	𒅎	sux
muru3	IM	𒅎	sux
car5	IM	𒅎	sux
cara5	IM	𒅎	sux
ceg7	IM	𒅎	sux
cej7	IM	𒅎	sux
tecub	IM	𒅎	sux
tid	IM	𒅎	sux
tu15	IM	𒅎	sux
tum9	IM	𒅎	sux
tumu	IM	𒅎	sux
cegx	|IM.A|	𒅎𒀀	sux
cegx	|IM.A.A|	𒅎𒀀𒀀	sux
ceg14	|IM.A.AN|	𒅎𒀀𒀭	sux
cej14	|IM.A.AN|	𒅎𒀀𒀭	sux
cerkan	|IM.DUB₂|	𒅎𒂀	sux
agar6	|IM.DUGUD|	𒅎𒂂	sux
ajar6	|IM.DUGUD|	𒅎𒂂	sux
muru9	|IM.DUGUD|	𒅎𒂂	sux
suhul3	|IM.DUN.DUN₃@g@g|	𒅎𒂄𒂇	sux
suhul2	|IM.DUN3@g@g.DUN|	𒅎𒂇𒂄	sux
uluba	|IM.GAN₂.HI×NUN.ME.U|	𒅎𒃷𒄴𒈨𒌋	sux
ulubar	|IM.GAN₂.HI×NUN.ME.U|	𒅎𒃷𒄴𒈨𒌋	sux
ulumac	|IM.GAN₂.HI×NUN.ME.U|	𒅎𒃷𒄴𒈨𒌋	sux
uluba2	|IM.HI×NUN.ME.U.GAN₂|	𒅎𒄴𒈨𒌋𒃷	sux
ulubar2	|IM.HI×NUN.ME.U.GAN₂|	𒅎𒄴𒈨𒌋𒃷	sux
ulumac2	|IM.HI×NUN.ME.U.GAN₂|	𒅎𒄴𒈨𒌋𒃷	sux
tukx	|IM.KAD₃|	𒅎𒆑	sux
dungax	|IM.SI.A|	𒅎𒋛𒀀	sux
dungu	|IM.SI.A|	𒅎𒋛𒀀	sux
dalhamun	|IM.ŠITA|	𒅎𒋖	sux
cux	|IM.ŠU₂|	𒅎𒋙	sux
uh6	|IM.ŠU₂|	𒅎𒋙	sux
ahud	|4×IM|	𒅒	sux
merimer4	|4×IM|	𒅒	sux
merimeri4	|4×IM|	𒅒	sux
mermer4	|4×IM|	𒅒	sux
mermeri4	|4×IM|	𒅒	sux
kid7	|IM×TAK₄|	𒅏	sux
tug7	|IM×TAK₄|	𒅏	sux
tuk7	|IM×TAK₄|	𒅏	sux
agar5	|IM%IM|	𒅐	sux
ajar5	|IM%IM|	𒅐	sux
angar	|IM%IM|	𒅐	sux
dalhamun6	|IM%IM|	𒅐	sux
merimer3	|IM%IM|	𒅐	sux
merimeri3	|IM%IM|	𒅐	sux
mermer3	|IM%IM|	𒅐	sux
mermeri3	|IM%IM|	𒅐	sux
nimgigre	|IM%IM|	𒅐	sux
zigara	|IM%IM|	𒅐	sux
zigkaru	|IM%IM|	𒅐	sux
zikara	|IM%IM|	𒅐	sux
zikaru	|IM%IM|	𒅐	sux
dalhamunx	|IM@IM|	𒅑	sux
imin	IMIN	𒅓	sux
imina	IMIN	𒅓	sux
umun7	IMIN	𒅓	sux
umunax	IMIN	𒅓	sux
LAK214	IN	𒅔	sux
en6	IN	𒅔	sux
gir12	IN	𒅔	sux
in	IN	𒅔	sux
ini	IN	𒅔	sux
isin2	IN	𒅔	sux
LAK507	IR	𒅕	sux
erecu	IR	𒅕	sux
er	IR	𒅕	sux
ere14	IR	𒅕	sux
erec3	IR	𒅕	sux
eri14	IR	𒅕	sux
ir	IR	𒅕	sux
ire14	IR	𒅕	sux
iri14	IR	𒅕	sux
LAK163	IŠ	𒅖	sux
es5	IŠ	𒅖	sux
ec15	IŠ	𒅖	sux
is2	IŠ	𒅖	sux
isi	IŠ	𒅖	sux
isic	IŠ	𒅖	sux
iś	IŠ	𒅖	sux
ic	IŠ	𒅖	sux
ici	IŠ	𒅖	sux
is,2	IŠ	𒅖	sux
iz2	IŠ	𒅖	sux
kukkuda2	IŠ	𒅖	sux
kukkuc	IŠ	𒅖	sux
kukuda2	IŠ	𒅖	sux
kuc7	IŠ	𒅖	sux
mel	IŠ	𒅖	sux
mil	IŠ	𒅖	sux
mili	IŠ	𒅖	sux
milla	IŠ	𒅖	sux
sahar	IŠ	𒅖	sux
sahardub	IŠ	𒅖	sux
sucx	IŠ	𒅖	sux
cen6	IŠ	𒅖	sux
cuc3	IŠ	𒅖	sux
ukum	IŠ	𒅖	sux
LAK318	KA	𒅗	sux
MZL24	KA	𒅗	sux
bux	KA	𒅗	sux
da12	KA	𒅗	sux
dag5	KA	𒅗	sux
du11	KA	𒅗	sux
dug4	KA	𒅗	sux
duga4	KA	𒅗	sux
e7	KA	𒅗	sux
emex	KA	𒅗	sux
en4	KA	𒅗	sux
/enej/	KA	𒅗	sux
enem	KA	𒅗	sux
enim	KA	𒅗	sux
ga14	KA	𒅗	sux
gir17	KA	𒅗	sux
giri17	KA	𒅗	sux
gu3	KA	𒅗	sux
gur18	KA	𒅗	sux
i5	KA	𒅗	sux
inim	KA	𒅗	sux
ic5	KA	𒅗	sux
ka	KA	𒅗	sux
kag2	KA	𒅗	sux
kak2	KA	𒅗	sux
kir4	KA	𒅗	sux
kiri3	KA	𒅗	sux
mex	KA	𒅗	sux
nagx	KA	𒅗	sux
pe4	KA	𒅗	sux
pi4	KA	𒅗	sux
pu5	KA	𒅗	sux
qirx	KA	𒅗	sux
qa3	KA	𒅗	sux
sigx	KA	𒅗	sux
su11	KA	𒅗	sux
sugx	KA	𒅗	sux
sumux	KA	𒅗	sux
sumurx	KA	𒅗	sux
ce28	KA	𒅗	sux
ced17	KA	𒅗	sux
ceg13	KA	𒅗	sux
cix	KA	𒅗	sux
cudx	KA	𒅗	sux
uzugx	KA	𒅗	sux
zib4	KA	𒅗	sux
zu2	KA	𒅗	sux
zug2	KA	𒅗	sux
zuh	KA	𒅗	sux
babila	|KA.AN|	𒅗𒀭	sux
kurku2	|KA.AN.NI.SI|	𒅗𒀭𒉌𒋛	sux
babila2	|KA.AN.RA|	𒅗𒀭𒊏	sux
bizaza	|KA.BALAG.GA₂.TE.A.DU@s.ZA.NA|	𒅗𒁆𒂷𒋼𒀀𒁽𒍝𒈾	sux
ictaran	|KA.DI|	𒅗𒁲	sux
tēmu	|KA.HI|	𒅗𒄭	sux
demma	|KA.HI|	𒅗𒄭	sux
demmu	|KA.HI|	𒅗𒄭	sux
dema	|KA.HI|	𒅗𒄭	sux
demu	|KA.HI|	𒅗𒄭	sux
dima	|KA.HI|	𒅗𒄭	sux
dimma	|KA.HI|	𒅗𒄭	sux
dimmu	|KA.HI|	𒅗𒄭	sux
dimu	|KA.HI|	𒅗𒄭	sux
munx	|KA.HI.GA|	𒅗𒄭𒂵	sux
ummax	|KA.HI.GA|	𒅗𒄭𒂵	sux
dutu	|KA.KA|	𒅗𒅗	sux
gug6	|KA.KAK|	𒅗𒆕	sux
pihu3	|KA.KAK|	𒅗𒆕	sux
cudx	|KA.ŠU|	𒅗𒋗	sux
LAK331	|KA×A|	𒅘	sux
MZL64	|KA×A|	𒅘	sux
emma2	|KA×A|	𒅘	sux
emmen2	|KA×A|	𒅘	sux
emmin2	|KA×A|	𒅘	sux
enmen2	|KA×A|	𒅘	sux
gab3	|KA×A|	𒅘	sux
gu6	|KA×A|	𒅘	sux
imma2	|KA×A|	𒅘	sux
immeli	|KA×A|	𒅘	sux
immen2	|KA×A|	𒅘	sux
immin2	|KA×A|	𒅘	sux
kab2	|KA×A|	𒅘	sux
na8	|KA×A|	𒅘	sux
nag	|KA×A|	𒅘	sux
naga2	|KA×A|	𒅘	sux
naj	|KA×A|	𒅘	sux
nak	|KA×A|	𒅘	sux
namx	|KA×A|	𒅘	sux
naq	|KA×A|	𒅘	sux
nik5	|KA×A|	𒅘	sux
akx	|KA×AD|	𒅙	sux
MZL34	|KA×(AD.KU₃)|	𒅚	sux
nagiri	|KA×(AD.KU₃)|	𒅚	sux
nigru	|KA×(AD.KU₃)|	𒅚	sux
MZL45	|KA×AŠ₂|	𒅛	sux
ibira2	|KA×AŠ₂|	𒅛	sux
MZL29	|KA×BAD|	𒅜	sux
uh4	|KA×BAD|	𒅜	sux
uc11	|KA×BAD|	𒅜	sux
MZL47	|KA×BALAG|	𒅝	sux
gudiddi	|KA×BALAG|	𒅝	sux
si18	|KA×BALAG|	𒅝	sux
sigx	|KA×BALAG|	𒅝	sux
ce26	|KA×BALAG|	𒅝	sux
ced15	|KA×BALAG|	𒅝	sux
ceg11	|KA×BALAG|	𒅝	sux
cix	|KA×BALAG|	𒅝	sux
cidx	|KA×BALAG|	𒅝	sux
cigx	|KA×BALAG|	𒅝	sux
MZL62	|KA×EŠ₂|	𒅡	sux
ma5	|KA×EŠ₂|	𒅡	sux
mu3	|KA×EŠ₂|	𒅡	sux
sub4	|KA×EŠ₂|	𒅡	sux
MZL44	|KA×GA|	𒅢	sux
simx	|KA×GA|	𒅢	sux
sub	|KA×GA|	𒅢	sux
cubx	|KA×GA|	𒅢	sux
kulkul	|KA×GA.SAG|	𒅢𒊕	sux
agal	|KA×GAL|	𒅣	sux
LAK324	|KA×GAN₂@t|	𒅤	sux
MZL33	|KA×GAN₂@t|	𒅤	sux
puzru	|KA×GAN₂@t|	𒅤	sux
ba11	|KA×GAN₂@t|	𒅤	sux
bu3	|KA×GAN₂@t|	𒅤	sux
bum	|KA×GAN₂@t|	𒅤	sux
burx	|KA×GAN₂@t|	𒅤	sux
buzur5	|KA×GAN₂@t|	𒅤	sux
kala	|KA×GAN₂@t|	𒅤	sux
kan6	|KA×GAN₂@t|	𒅤	sux
kana6	|KA×GAN₂@t|	𒅤	sux
mux	|KA×GAN₂@t|	𒅤	sux
pu3	|KA×GAN₂@t|	𒅤	sux
pum	|KA×GAN₂@t|	𒅤	sux
puzur5	|KA×GAN₂@t|	𒅤	sux
tugure	|KA×GAN₂@t|	𒅤	sux
puzru	|KA×GAN₂@t.ŠA|	𒅤𒊭	sux
buzur4	|KA×GAN₂@t.ŠA|	𒅤𒊭	sux
puzur4	|KA×GAN₂@t.ŠA|	𒅤𒊭	sux
MZL65	|KA×GAR|	𒅥	sux
LAK330	|KA×GAR|	𒅥	sux
gu7	|KA×GAR|	𒅥	sux
ku2	|KA×GAR|	𒅥	sux
kur8	|KA×GAR|	𒅥	sux
cagar	|KA×GAR|	𒅥	sux
cajar	|KA×GAR|	𒅥	sux
MZL66	|KA×(GAR.ŠA₃.A)|	𒅦	sux
melex	|KA×(GAR.ŠA₃.A)|	𒅦	sux
melix	|KA×(GAR.ŠA₃.A)|	𒅦	sux
LAK320	|KA×GIR₂|	𒅨	sux
MZL25	|KA×GIR₂|	𒅨	sux
emex-gir2	|KA×GIR₂|	𒅨	sux
emex	|KA×GIR₂|	𒅨	sux
MZL37	|KA×GIŠ%GIŠ|	𒅪	sux
gasa	|KA×GIŠ%GIŠ|	𒅪	sux
gaza3	|KA×GIŠ%GIŠ|	𒅪	sux
ibira	|KA×GIŠ%GIŠ|	𒅪	sux
irhandix	|KA×GIŠ%GIŠ|	𒅪	sux
nehandix	|KA×GIŠ%GIŠ|	𒅪	sux
tibira2	|KA×GIŠ%GIŠ|	𒅪	sux
gukri	|KA×(GIŠ.SAR)|	𒅩	sux
MZL63	|KA×GUR₇|	𒅬	sux
kugre	|KA×GUR₇|	𒅬	sux
kugur	|KA×GUR₇|	𒅬	sux
LAK326	|KA×IM|	𒅮	sux
MZL54	|KA×IM|	𒅮	sux
ba5	|KA×IM|	𒅮	sux
bu13	|KA×IM|	𒅮	sux
buhx	|KA×IM|	𒅮	sux
bul4	|KA×IM|	𒅮	sux
bun2	|KA×IM|	𒅮	sux
kirix	|KA×IM|	𒅮	sux
tux	|KA×IM|	𒅮	sux
MZL38	|KA×KAK|	𒅯	sux
kir14	|KA×KAK|	𒅯	sux
MZL60	|KA×KI|	𒅰	sux
dunx	|KA×KID|	𒅱	sux
sux	|KA×KID|	𒅱	sux
sulx	|KA×KID|	𒅱	sux
sumx	|KA×KID|	𒅱	sux
sunx	|KA×KID|	𒅱	sux
MZL26	|KA×LI|	𒅲	sux
gele3	|KA×LI|	𒅲	sux
geli3	|KA×LI|	𒅲	sux
gili3	|KA×LI|	𒅲	sux
gilib3	|KA×LI|	𒅲	sux
girix	|KA×LI|	𒅲	sux
jeli3	|KA×LI|	𒅲	sux
jili3	|KA×LI|	𒅲	sux
jirix	|KA×LI|	𒅲	sux
mel2	|KA×LI|	𒅲	sux
mele2	|KA×LI|	𒅲	sux
meli2	|KA×LI|	𒅲	sux
mili2	|KA×LI|	𒅲	sux
mu7	|KA×LI|	𒅲	sux
mumunx	|KA×LI|	𒅲	sux
munx	|KA×LI|	𒅲	sux
sug7	|KA×LI|	𒅲	sux
cegx	|KA×LI|	𒅲	sux
tu6	|KA×LI|	𒅲	sux
uc7	|KA×LI|	𒅲	sux
zug4	|KA×LI|	𒅲	sux
zuhx	|KA×LI|	𒅲	sux
MZL48~a	|KA×ŠA|	𒆀	sux
mu13~a	|KA×ŠA|	𒆀	sux
mummun	|KA×LI.KA×LI|	𒅲𒅲	sux
mumun	|KA×LI.KA×LI|	𒅲𒅲	sux
pu-udu	|KA×LU|	𒅳	sux
LAK334	|KA×ME|	𒅴	sux
MZL61	|KA×ME|	𒅴	sux
em4	|KA×ME|	𒅴	sux
eme	|KA×ME|	𒅴	sux
uli	|KA×ME|	𒅴	sux
medu	|KA×(ME.DU)|	𒅵	sux
meca	|KA×(ME.DU)|	𒅵	sux
emengi	|KA×(ME.GI)|	𒅶	sux
imminte	|KA×(ME.TE)|	𒅷	sux
MZL35	|KA×NE|	𒅺	sux
murgu3	|KA×NE|	𒅺	sux
urgu2	|KA×NE|	𒅺	sux
MZL31	|KA×NUN|	𒅻	sux
numdu	|KA×NUN|	𒅻	sux
numdum	|KA×NUN|	𒅻	sux
numdun	|KA×NUN|	𒅻	sux
nundu	|KA×NUN|	𒅻	sux
nundum	|KA×NUN|	𒅻	sux
nundun	|KA×NUN|	𒅻	sux
/cumdum/	|KA×NUN|	𒅻	sux
MZL52	|KA×PI|	𒅼	sux
terx	|KA×PI|	𒅼	sux
uc14	|KA×PI|	𒅼	sux
MZL28	|KA×RU|	𒅽	sux
gilib4	|KA×RU|	𒅽	sux
LAK333	|KA×SA|	𒅾	sux
MZL32	|KA×SA|	𒅾	sux
dunx	|KA×SA|	𒅾	sux
mangaga	|KA×SA|	𒅾	sux
su6	|KA×SA|	𒅾	sux
sul3	|KA×SA|	𒅾	sux
sum4	|KA×SA|	𒅾	sux
sun4	|KA×SA|	𒅾	sux
tunx	|KA×SA|	𒅾	sux
LAK325	|KA×SAR|	𒅿	sux
MZL45	|KA×SAR|	𒅿	sux
gukiri	|KA×SAR|	𒅿	sux
ma8	|KA×SAR|	𒅿	sux
mu11	|KA×SAR|	𒅿	sux
MZL68	|KA×SIG|	𒆄	sux
emesig	|KA×SIG|	𒆄	sux
munsubx	|KA×SUHUR|	𒆅	sux
LAK322	|KA×ŠE|	𒆁	sux
MZL50	|KA×ŠE|	𒆁	sux
tukur2	|KA×ŠE|	𒆁	sux
tukurex	|KA×ŠE|	𒆁	sux
MZL42	|KA×ŠID|	𒆂	sux
dilib2	|KA×ŠID|	𒆂	sux
giguru3	|KA×ŠID|	𒆂	sux
sigx	|KA×ŠID|	𒆂	sux
silig6	|KA×ŠID|	𒆂	sux
ce25	|KA×ŠID|	𒆂	sux
ced14	|KA×ŠID|	𒆂	sux
ceg10	|KA×ŠID|	𒆂	sux
cigx	|KA×ŠID|	𒆂	sux
cilig6	|KA×ŠID|	𒆂	sux
ciq4	|KA×ŠID|	𒆂	sux
LAK323	|KA×ŠU|	𒆃	sux
MZL49	|KA×ŠU|	𒆃	sux
burx	|KA×ŠU|	𒆃	sux
cex	|KA×ŠU|	𒆃	sux
cedx	|KA×ŠU|	𒆃	sux
cegx	|KA×ŠU|	𒆃	sux
cix	|KA×ŠU|	𒆃	sux
cu12	|KA×ŠU|	𒆃	sux
cud3	|KA×ŠU|	𒆃	sux
cude3	|KA×ŠU|	𒆃	sux
cudu3	|KA×ŠU|	𒆃	sux
cucudi	|KA×ŠU|	𒆃	sux
ucx	|KA×ŠU|	𒆃	sux
zukura	|KA×TAR|	𒆆	sux
LAK319	|KA×U|	𒆇	sux
LAK321	|KA×U₂|	𒆈	sux
MZL43	|KA×U₂|	𒆈	sux
melex	|KA×U₂|	𒆈	sux
melix	|KA×U₂|	𒆈	sux
musug5	|KA×U₂|	𒆈	sux
tukur3	|KA×U₂|	𒆈	sux
usug5	|KA×U₂|	𒆈	sux
uzug5	|KA×U₂|	𒆈	sux
MZL51	|KA×UD|	𒆉	sux
emma	|KA×UD|	𒆉	sux
emmen	|KA×UD|	𒆉	sux
emmin	|KA×UD|	𒆉	sux
enmen	|KA×UD|	𒆉	sux
imma	|KA×UD|	𒆉	sux
immen	|KA×UD|	𒆉	sux
immin	|KA×UD|	𒆉	sux
si19	|KA×UD|	𒆉	sux
subx	|KA×UD|	𒆉	sux
tux	|KA×UD|	𒆉	sux
za6	|KA×UD|	𒆉	sux
zu9	|KA×UD|	𒆉	sux
MZL51	|KA×UD.BAR|	𒆉𒁇	sux
KAxUD-bar	|KA×UD.BAR|	𒆉𒁇	sux
zabar3	|KA×UD.BAR|	𒆉𒁇	sux
zibar3	|KA×UD.BAR|	𒆉𒁇	sux
gudedde	|KA×UMUM×PA|	𒆊	sux
MZL39	|KA×UŠ|	𒆋	sux
durix	|KA×UŠ|	𒆋	sux
ugal	|KA×UŠ|	𒆋	sux
LAK335	|KA×ZI|	𒆌	sux
guzix	|KA×ZI|	𒆌	sux
LAK735	KA₂	𒆍	sux
aganx	KA₂	𒆍	sux
aka4	KA₂	𒆍	sux
akan2	KA₂	𒆍	sux
baba2	KA₂	𒆍	sux
babu	KA₂	𒆍	sux
gu16	KA₂	𒆍	sux
ka2	KA₂	𒆍	sux
kan4	KA₂	𒆍	sux
kankan	KA₂	𒆍	sux
papa2	KA₂	𒆍	sux
babilax	|KA₂.AN|	𒆍𒀭	sux
babilim	|KA₂.AN|	𒆍𒀭	sux
babilima	|KA₂.AN|	𒆍𒀭	sux
babilim2	|KA₂.AN.RA|	𒆍𒀭𒊏	sux
babilima2	|KA₂.AN.RA|	𒆍𒀭𒊏	sux
abul	|KA₂.GAL|	𒆍𒃲	sux
abula	|KA₂.GAL|	𒆍𒃲	sux
abulla	|KA₂.GAL|	𒆍𒃲	sux
[...]	|KA₂%KA₂|	𒆎	sux
LAK474	KAB	𒆏	sux
gab2	KAB	𒆏	sux
gaba2	KAB	𒆏	sux
gabu2	KAB	𒆏	sux
gap2	KAB	𒆏	sux
gub3	KAB	𒆏	sux
gubu3	KAB	𒆏	sux
kab	KAB	𒆏	sux
kap	KAB	𒆏	sux
kapa	KAB	𒆏	sux
qab2	KAB	𒆏	sux
qap2	KAB	𒆏	sux
gabux	|KAB.BU|	𒆏𒁍	sux
ragab3	|KAB.UŠ|	𒆏𒍑	sux
MZL108	KAD₂	𒆐	sux
gat2	KAD₂	𒆐	sux
kad2	KAD₂	𒆐	sux
kat2	KAD₂	𒆐	sux
qad6	KAD₂	𒆐	sux
qat6	KAD₂	𒆐	sux
cid2	KAD₂	𒆐	sux
MZL109	KAD₃	𒆑	sux
gat3	KAD₃	𒆑	sux
kad3	KAD₃	𒆑	sux
kat3	KAD₃	𒆑	sux
kata3	KAD₃	𒆑	sux
kud6	KAD₃	𒆑	sux
qat7	KAD₃	𒆑	sux
ced4	KAD₃	𒆑	sux
cecced2	|KAD₃.KAD₃|	𒆑𒆑	sux
LAK171?	KAD₄	𒆒	sux
gechur	KAD₄	𒆒	sux
geckad	KAD₄	𒆒	sux
gichur	KAD₄	𒆒	sux
gickad	KAD₄	𒆒	sux
had4	KAD₄	𒆒	sux
kad4	KAD₄	𒆒	sux
kam3	KAD₄	𒆒	sux
karx	KAD₄	𒆒	sux
kara4	KAD₄	𒆒	sux
kat4	KAD₄	𒆒	sux
kid5	KAD₄	𒆒	sux
kim2	KAD₄	𒆒	sux
pec5	KAD₄	𒆒	sux
pic5	KAD₄	𒆒	sux
qat5	KAD₄	𒆒	sux
ced5	KAD₄	𒆒	sux
unu9	KAD₄	𒆒	sux
cecced3	|KAD₄.KAD₄.KAD₅|	𒆒𒆒𒆓	sux
LAK173?	KAD₅	𒆓	sux
bansur3	KAD₅	𒆓	sux
bancur3	KAD₅	𒆓	sux
kad5	KAD₅	𒆓	sux
kat5	KAD₅	𒆓	sux
kid6	KAD₅	𒆓	sux
kimx	KAD₅	𒆓	sux
pec6	KAD₅	𒆓	sux
pic6	KAD₅	𒆓	sux
qat8	KAD₅	𒆓	sux
esir3	|KAD₅.KAD₅|	𒆓𒆓	sux
tal5	|KAD₅.KAD₅|	𒆓𒆓	sux
til6	|KAD₅.KAD₅|	𒆓𒆓	sux
esirx	|KAD₅&KAD₅|	𒆔	sux
talx	|KAD₅&KAD₅.KAD₅&KAD₅|	𒆔𒆔	sux
tilx	|KAD₅&KAD₅.KAD₅&KAD₅|	𒆔𒆔	sux
LAK504	KAK	𒆕	sux
ban4	KAK	𒆕	sux
da3	KAK	𒆕	sux
du3	KAK	𒆕	sux
gag	KAK	𒆕	sux
gak	KAK	𒆕	sux
henbur	KAK	𒆕	sux
ka15	KAK	𒆕	sux
kak	KAK	𒆕	sux
kal3	KAK	𒆕	sux
kaq	KAK	𒆕	sux
ki7	KAK	𒆕	sux
qa6	KAK	𒆕	sux
qaq	KAK	𒆕	sux
qi6	KAK	𒆕	sux
re12	KAK	𒆕	sux
ri12	KAK	𒆕	sux
ru2	KAK	𒆕	sux
tu20	KAK	𒆕	sux
usanx	KAK	𒆕	sux
zarx	KAK	𒆕	sux
LAK505	|KAK.GIŠ|	𒆕𒄑	sux
citax	|KAK.GIŠ|	𒆕𒄑	sux
LAK304	|KAK.TAR|	𒆕𒋻	sux
kucu2	|KAK.TAR|	𒆕𒋻	sux
kuksu2	|KAK.TAR|	𒆕𒋻	sux
LAK709b	KAL	𒆗	sux
dannu	KAL	𒆗	sux
etlu	KAL	𒆗	sux
alad2	KAL	𒆗	sux
bactum	KAL	𒆗	sux
dan	KAL	𒆗	sux
dana3	KAL	𒆗	sux
dun6	KAL	𒆗	sux
esi	KAL	𒆗	sux
esig	KAL	𒆗	sux
ecax	KAL	𒆗	sux
gal9	KAL	𒆗	sux
kal	KAL	𒆗	sux
kala	KAL	𒆗	sux
kalag	KAL	𒆗	sux
kalaga	KAL	𒆗	sux
kalga	KAL	𒆗	sux
la6	KAL	𒆗	sux
lab	KAL	𒆗	sux
lala2	KAL	𒆗	sux
lama3	KAL	𒆗	sux
lamar	KAL	𒆗	sux
lamassu	KAL	𒆗	sux
lamma	KAL	𒆗	sux
lammar	KAL	𒆗	sux
lap	KAL	𒆗	sux
lib2	KAL	𒆗	sux
lip2	KAL	𒆗	sux
mirx	KAL	𒆗	sux
nir6	KAL	𒆗	sux
qal4	KAL	𒆗	sux
rab4	KAL	𒆗	sux
reb	KAL	𒆗	sux
rib	KAL	𒆗	sux
rip	KAL	𒆗	sux
rub	KAL	𒆗	sux
sa14	KAL	𒆗	sux
sag8	KAL	𒆗	sux
seg15	KAL	𒆗	sux
si21	KAL	𒆗	sux
sig15	KAL	𒆗	sux
silim2	KAL	𒆗	sux
silima2	KAL	𒆗	sux
subx	KAL	𒆗	sux
sun7	KAL	𒆗	sux
sunax	KAL	𒆗	sux
cedu	KAL	𒆗	sux
s,urs,ub2	KAL	𒆗	sux
tan	KAL	𒆗	sux
tana	KAL	𒆗	sux
tan	KAL	𒆗	sux
urrub2	KAL	𒆗	sux
ursub2	KAL	𒆗	sux
zi8	KAL	𒆗	sux
zurzub2	KAL	𒆗	sux
birdu	|KAL.EDIN|	𒆗𒂔	sux
carap	|KAL.EDIN|	𒆗𒂔	sux
alad	|KAL×BAD|	𒆘	sux
liri7	|KAL%KAL|	𒆙	sux
liru7	|KAL%KAL|	𒆙	sux
lirum7	|KAL%KAL|	𒆙	sux
eric7	KAM₂	𒆚	sux
kam2	KAM₂	𒆚	sux
udul7	KAM₂	𒆚	sux
utul7	KAM₂	𒆚	sux
LAK29	KAM₄	𒆛	sux
MZL97	KAM₄	𒆛	sux
gam3	KAM₄	𒆛	sux
kam4	KAM₄	𒆛	sux
kimx	KAM₄	𒆛	sux
LAK273	KASKAL	𒆜	sux
bu2	KASKAL	𒆜	sux
buc	KASKAL	𒆜	sux
dana2	KASKAL	𒆜	sux
danna2	KASKAL	𒆜	sux
ec8	KASKAL	𒆜	sux
ir7	KASKAL	𒆜	sux
ic2	KASKAL	𒆜	sux
kas	KASKAL	𒆜	sux
kasa	KASKAL	𒆜	sux
kaskal	KASKAL	𒆜	sux
kac2	KASKAL	𒆜	sux
kaz0	KASKAL	𒆜	sux
ras	KASKAL	𒆜	sux
rac	KASKAL	𒆜	sux
rin6	KASKAL	𒆜	sux
cubtumx	KASKAL	𒆜	sux
zikura	|KASKAL.6(DIŠ)|	𒆜𒐋	sux
dana	|KASKAL.BU|	𒆜𒁍	sux
danna	|KASKAL.BU|	𒆜𒁍	sux
LAK275	|KASKAL.GA|	𒆜𒂵	sux
gaec2	|KASKAL.GA|	𒆜𒂵	sux
gaic2	|KASKAL.GA|	𒆜𒂵	sux
garac4	|KASKAL.GA|	𒆜𒂵	sux
kici15	|KASKAL.HI×NUN|	𒆜𒄴	sux
MZL304	|KASKAL.KUR|	𒆜𒆳	sux
illatu	|KASKAL.KUR|	𒆜𒆳	sux
alba2	|KASKAL.KUR|	𒆜𒆳	sux
alha	|KASKAL.KUR|	𒆜𒆳	sux
baliha	|KASKAL.KUR|	𒆜𒆳	sux
ellat	|KASKAL.KUR|	𒆜𒆳	sux
ilba2	|KASKAL.KUR|	𒆜𒆳	sux
ilha	|KASKAL.KUR|	𒆜𒆳	sux
illat	|KASKAL.KUR|	𒆜𒆳	sux
cubtu	|KASKAL.LAGAB|	𒆜𒆸	sux
cubtu3	|KASKAL.LAGAB|	𒆜𒆸	sux
cubtum3	|KASKAL.LAGAB|	𒆜𒆸	sux
cubtu5	|KASKAL.LAGAB×U|	𒆜𒇥	sux
cubtum5	|KASKAL.LAGAB×U|	𒆜𒇥	sux
cubtu6	|KASKAL.(LAGAB×U)&(LAGAB×U)|	𒆝	sux
cubtum6	|KASKAL.(LAGAB×U)&(LAGAB×U)|	𒆝	sux
cubtu7	|(KASKAL.LAGAB×U)&(KASKAL.LAGAB×U)|	𒆞	sux
cubtum7	|(KASKAL.LAGAB×U)&(KASKAL.LAGAB×U)|	𒆞	sux
iti3	|KASKAL.UD@s|	𒆜𒌚	sux
LAK612	KEŠ₂	𒆟	sux
gir11	KEŠ₂	𒆟	sux
giri11	KEŠ₂	𒆟	sux
girid	KEŠ₂	𒆟	sux
her	KEŠ₂	𒆟	sux
hir	KEŠ₂	𒆟	sux
kec2	KEŠ₂	𒆟	sux
kecda	KEŠ₂	𒆟	sux
kece2	KEŠ₂	𒆟	sux
keci2	KEŠ₂	𒆟	sux
kiri7	KEŠ₂	𒆟	sux
kirid	KEŠ₂	𒆟	sux
kiris	KEŠ₂	𒆟	sux
kirit	KEŠ₂	𒆟	sux
kic2	KEŠ₂	𒆟	sux
kici2	KEŠ₂	𒆟	sux
LAK440	KI	𒆠	sux
ers,etu	KI	𒆠	sux
qaqqaru	KI	𒆠	sux
ammax	KI	𒆠	sux
gagar	KI	𒆠	sux
ge5	KI	𒆠	sux
gi5	KI	𒆠	sux
gu14	KI	𒆠	sux
jicbunx	KI	𒆠	sux
ke	KI	𒆠	sux
ki	KI	𒆠	sux
ku11	KI	𒆠	sux
qe2	KI	𒆠	sux
qi2	KI	𒆠	sux
sasx	KI	𒆠	sux
ubdax	KI	𒆠	sux
pec10	|KI.A|	𒆠𒀀	sux
pic10	|KI.A|	𒆠𒀀	sux
qutra	|KI.AN.IM|	𒆠𒀭𒅎	sux
kutra	|KI.AN.IM|	𒆠𒀭𒅎	sux
munzer	|KI.AN.ŠEŠ.KI|	𒆠𒀭𒋀𒆠	sux
munzur	|KI.AN.ŠEŠ.KI|	𒆠𒀭𒋀𒆠	sux
musur	|KI.AN.ŠEŠ.KI|	𒆠𒀭𒋀𒆠	sux
cakirx	|KI.AN.UD|	𒆠𒀭𒌓	sux
cakira2	|KI.AN.UD|	𒆠𒀭𒌓	sux
absin	|KI.AŠ.AŠ|	𒆠𒀸𒀸	sux
gisbun	|KI.AŠ.AŠ|	𒆠𒀸𒀸	sux
garacax	|KI.BAD|	𒆠𒁁	sux
gecbun2	|KI.BI|	𒆠𒁉	sux
jecbun2	|KI.BI|	𒆠𒁉	sux
jicbun2	|KI.BI|	𒆠𒁉	sux
gecbun	|KI.BI.GAR|	𒆠𒁉𒃻	sux
gicbun	|KI.BI.GAR|	𒆠𒁉𒃻	sux
jecbun	|KI.BI.GAR|	𒆠𒁉𒃻	sux
jicbum	|KI.BI.GAR|	𒆠𒁉𒃻	sux
jicbun	|KI.BI.GAR|	𒆠𒁉𒃻	sux
gizbun	|KI.BI.GAR|	𒆠𒁉𒃻	sux
cubun	|KI.BI.GAR|	𒆠𒁉𒃻	sux
...ga	|KI.BI.KAK|	𒆠𒁉𒆕	sux
kibini	|KI.BI.NI|	𒆠𒁉𒉌	sux
citen	|KI.DU.KAK|	𒆠𒁺𒆕	sux
ecemen	|KI.E.NE.DI|	𒆠𒂊𒉈𒁲	sux
ecemin	|KI.E.NE.DI|	𒆠𒂊𒉈𒁲	sux
ecemen2	|KI.E.NE.DI.AN.MUŠ₃|	𒆠𒂊𒉈𒁲𒀭𒈹	sux
ecemin2	|KI.E.NE.DI.AN.MUŠ₃|	𒆠𒂊𒉈𒁲𒀭𒈹	sux
bur11	|KI.EN.KAK|	𒆠𒂗𒆕	sux
buru11	|KI.EN.KAK|	𒆠𒂗𒆕	sux
mur6	|KI.EN.KAK|	𒆠𒂗𒆕	sux
muru6	|KI.EN.KAK|	𒆠𒂗𒆕	sux
murum6	|KI.EN.KAK|	𒆠𒂗𒆕	sux
sur6	|KI.GAL|	𒆠𒃲	sux
dudu	|KI.IB|	𒆠𒅁	sux
ecceb	|KI.IB|	𒆠𒅁	sux
uctuh	|KI.IB|	𒆠𒅁	sux
engarx	|KI.KA.LU₂|	𒆠𒅗𒇽	sux
sur7	|KI.KAK|	𒆠𒆕	sux
bad4	|KI.KAL|	𒆠𒆗	sux
dubad	|KI.KAL|	𒆠𒆗	sux
garac5	|KI.KAL|	𒆠𒆗	sux
hirim	|KI.KAL|	𒆠𒆗	sux
hirin	|KI.KAL|	𒆠𒆗	sux
kankal	|KI.KAL|	𒆠𒆗	sux
karac2	|KI.KAL|	𒆠𒆗	sux
kikla	|KI.KAL|	𒆠𒆗	sux
kislah3	|KI.KAL|	𒆠𒆗	sux
sas	|KI.KAL|	𒆠𒆗	sux
uludim	|KI.KAL|	𒆠𒆗	sux
uludin	|KI.KAL|	𒆠𒆗	sux
ulutim	|KI.KAL|	𒆠𒆗	sux
ulutin	|KI.KAL|	𒆠𒆗	sux
garac2	|KI.KAL.BAD|	𒆠𒆗𒁁	sux
karacx	|KI.KAL.BAD|	𒆠𒆗𒁁	sux
garacx	|KI.KAL.BAD.IDIM|	𒆠𒆗𒁁𒅂	sux
karacx	|KI.KAL.BAD.IDIM|	𒆠𒆗𒁁𒅂	sux
garac2	|KI.KAL×BAD|	𒆠𒆘	sux
karac	|KI.KAL×BAD|	𒆠𒆘	sux
kukku3	|KI.KI|	𒆠𒆠	sux
utte	|KI.KI|	𒆠𒆠	sux
utu4	|KI.KI|	𒆠𒆠	sux
ute	|KI.KI|	𒆠𒆠	sux
zarahx	|KI.KU.SAG|	𒆠𒆪𒊕	sux
uttu6	|KI.LAL|	𒆠𒇲	sux
utu6	|KI.LAL|	𒆠𒇲	sux
...ba	|KI.LAM|	𒆠𒇴	sux
ganba	|KI.LAM|	𒆠𒇴	sux
malba	|KI.LAM|	𒆠𒇴	sux
cakaka	|KI.LAM|	𒆠𒇴	sux
cakanka	|KI.LAM|	𒆠𒇴	sux
ugnimx	|KI.LU.EŠ₂|	𒆠𒇻𒂠	sux
ugnimx	|KI.SU.LU.EŠ₂.GAR.KI|	𒆠𒋢𒇻𒂠𒃻𒆠	sux
citenx	|KI.LUGAL|	𒆠𒈗	sux
kimin	|KI.MIN|	𒆠𒈫	sux
u7	|KI.MIN|	𒆠𒈫	sux
kukku4	|KI.MUŠ₃@g|	𒆠𒈽	sux
cutumx	|KI.NA.AB.TUM|	𒆠𒈾𒀊𒌈	sux
abni2	|KI.NE|	𒆠𒉈	sux
dinig	|KI.NE|	𒆠𒉈	sux
gibil3	|KI.NE|	𒆠𒉈	sux
gunni	|KI.NE|	𒆠𒉈	sux
izi2	|KI.NE|	𒆠𒉈	sux
kuclug	|KI.NE|	𒆠𒉈	sux
mel3	|KI.NE|	𒆠𒉈	sux
meli	|KI.NE|	𒆠𒉈	sux
munu2	|KI.NE|	𒆠𒉈	sux
ne5	|KI.NE|	𒆠𒉈	sux
nemur	|KI.NE|	𒆠𒉈	sux
nimur	|KI.NE|	𒆠𒉈	sux
zi7	|KI.NE|	𒆠𒉈	sux
digbir	|KI.NE.AN.MUŠ₃|	𒆠𒉈𒀭𒈹	sux
egi3	|KI.SAG|	𒆠𒊕	sux
igi3	|KI.SAG|	𒆠𒊕	sux
sulumx	|KI.SAG.DU|	𒆠𒊕𒁺	sux
sulummar	|KI.SAG.DU|	𒆠𒊕𒁺	sux
igira2	|KI.SAG.SAL|	𒆠𒊕𒊩	sux
igiru	|KI.SAG.SAL|	𒆠𒊕𒊩	sux
zarahx	|KI.SAG.SAL|	𒆠𒊕𒊩	sux
igirax~a	|KI.KA.SAL|	𒆠𒅗𒊩	sux
kicix	|KI.SAG@n|	𒆠𒊔	sux
ummanu	|KI.SU.LU.EŠ₂.GAR|	𒆠𒋢𒇻𒂠𒃻	sux
ugnim	|KI.SU.LU.EŠ₂.GAR|	𒆠𒋢𒇻𒂠𒃻	sux
umman	|KI.SU.LU.EŠ₂.GAR|	𒆠𒋢𒇻𒂠𒃻	sux
ugnimx	|KI.SU.LU.EŠ₂.GAR.RA|	𒆠𒋢𒇻𒂠𒃻𒊏	sux
ugnimx	|KI.SU.LU.GAR|	𒆠𒋢𒇻𒃻	sux
ugnimx	|KI.SU.LU.KI.GAR|	𒆠𒋢𒇻𒆠𒃻	sux
ugnimx	|KI.SU.LU.LAGAB×U.GAR|	𒆠𒋢𒇻𒇥𒃻	sux
ugnimx	|KI.SU.LU.ŠU.GAR|	𒆠𒋢𒇻𒋗𒃻	sux
ugnimx	|KI.SU.ZA.LU.EŠ₂|	𒆠𒋢𒍝𒇻𒂠	sux
kissa	|KI.ŠEŠ.KAK|	𒆠𒋀𒆕	sux
kislah	|KI.UD|	𒆠𒌓	sux
kizlah	|KI.UD|	𒆠𒌓	sux
kilahha	|KI.UD.A|	𒆠𒌓𒀀	sux
dagan	|KI.URU×MIN|	𒆠𒍇	sux
daggan	|KI.URU×MIN|	𒆠𒍇	sux
dakan	|KI.URU×MIN|	𒆠𒍇	sux
dakkan	|KI.URU×MIN|	𒆠𒍇	sux
suku4	|KI.URU×MIN|	𒆠𒍇	sux
habrud2	|KI×BAD|	𒆡	sux
habruda2	|KI×BAD|	𒆡	sux
habrud	|KI×U|	𒆢	sux
habruda	|KI×U|	𒆢	sux
hanburuda	|KI×U|	𒆢	sux
harx	|KI×U|	𒆢	sux
kislah2	|KI×UD|	𒆣	sux
LAK733	KID	𒆤	sux
bur6	KID	𒆤	sux
buru6	KID	𒆤	sux
ge2	KID	𒆤	sux
gi2	KID	𒆤	sux
gid	KID	𒆤	sux
git	KID	𒆤	sux
gub5	KID	𒆤	sux
gup5	KID	𒆤	sux
ke4	KID	𒆤	sux
ket	KID	𒆤	sux
ki4	KID	𒆤	sux
kid	KID	𒆤	sux
kit	KID	𒆤	sux
kit	KID	𒆤	sux
kub4	KID	𒆤	sux
kup4	KID	𒆤	sux
lel2	KID	𒆤	sux
lil2	KID	𒆤	sux
lila2	KID	𒆤	sux
muru12	KID	𒆤	sux
qi5	KID	𒆤	sux
qid	KID	𒆤	sux
qit	KID	𒆤	sux
sah	KID	𒆤	sux
seh2	KID	𒆤	sux
sih2	KID	𒆤	sux
suh4	KID	𒆤	sux
cah3	KID	𒆤	sux
cih2	KID	𒆤	sux
s,ah2	KID	𒆤	sux
tigix	|KID.BALAG|	𒆤𒁆	sux
amuru	|KID.MAH|	𒆤𒈤	sux
murux	|KID.ŠU₂.MA₂|	𒆤𒋙𒈣	sux
LAK174	KIN	𒆥	sux
gur10	KIN	𒆥	sux
ken	KIN	𒆥	sux
kig2	KIN	𒆥	sux
kij2	KIN	𒆥	sux
kimx	KIN	𒆥	sux
kin	KIN	𒆥	sux
kinga	KIN	𒆥	sux
kun10	KIN	𒆥	sux
qe	KIN	𒆥	sux
qi	KIN	𒆥	sux
qin	KIN	𒆥	sux
sag11	KIN	𒆥	sux
saga11	KIN	𒆥	sux
seg18	KIN	𒆥	sux
sig18	KIN	𒆥	sux
siga18	KIN	𒆥	sux
kenke	|KIN.KIN|	𒆥𒆥	sux
kingusila	KINGUSILI	𒑜	sux
kingusili	KINGUSILI	𒑜	sux
qimku	KINGUSILI	𒑜	sux
5/6(dic)	KINGUSILI	𒑜	sux
5/6(dic@c)	KINGUSILI	𒑜	sux
LAK723	KISAL	𒆦	sux
bur6	KISAL	𒆦	sux
dag4	KISAL	𒆦	sux
kisal	KISAL	𒆦	sux
par4	KISAL	𒆦	sux
lel4	KISAL	𒆦	sux
kisim5	KISIM₅	𒆨	sux
kicim5	KISIM₅	𒆨	sux
gingira	|KISIM₅&KISIM₅|	𒆩	sux
LAK248	KIŠ	𒆧	sux
kec	KIŠ	𒆧	sux
kis	KIŠ	𒆧	sux
kic	KIŠ	𒆧	sux
kicex	KIŠ	𒆧	sux
kici	KIŠ	𒆧	sux
kis,	KIŠ	𒆧	sux
qis	KIŠ	𒆧	sux
qic	KIŠ	𒆧	sux
be5	KU	𒆪	sux
bed3	KU	𒆪	sux
bet3	KU	𒆪	sux
bi7	KU	𒆪	sux
bid3	KU	𒆪	sux
bit3	KU	𒆪	sux
bu7	KU	𒆪	sux
bulx	KU	𒆪	sux
dab5	KU	𒆪	sux
daba5	KU	𒆪	sux
deb2	KU	𒆪	sux
dib2	KU	𒆪	sux
duc	KU	𒆪	sux
gu5	KU	𒆪	sux
gud7	KU	𒆪	sux
guz3	KU	𒆪	sux
hux	KU	𒆪	sux
ku	KU	𒆪	sux
kud3	KU	𒆪	sux
kuz3	KU	𒆪	sux
nu10	KU	𒆪	sux
qu2	KU	𒆪	sux
sahx	KU	𒆪	sux
su5	KU	𒆪	sux
suh5	KU	𒆪	sux
sur11	KU	𒆪	sux
suc	KU	𒆪	sux
ce10	KU	𒆪	sux
ced6	KU	𒆪	sux
ci5	KU	𒆪	sux
tibx	KU	𒆪	sux
tukul	KU	𒆪	sux
tukula	KU	𒆪	sux
tum5	KU	𒆪	sux
tuma	KU	𒆪	sux
tuc	KU	𒆪	sux
tucu	KU	𒆪	sux
tuc	KU	𒆪	sux
ugu4	KU	𒆪	sux
zap2	KU	𒆪	sux
mittu	|KU.AN|	𒆪𒀭	sux
medda	|KU.AN|	𒆪𒀭	sux
meddu	|KU.AN|	𒆪𒀭	sux
meta	|KU.AN|	𒆪𒀭	sux
metu	|KU.AN|	𒆪𒀭	sux
midda	|KU.AN|	𒆪𒀭	sux
middu	|KU.AN|	𒆪𒀭	sux
mitta	|KU.AN|	𒆪𒀭	sux
mittu	|KU.AN|	𒆪𒀭	sux
mitum	|KU.AN|	𒆪𒀭	sux
mita	|KU.AN|	𒆪𒀭	sux
mitu	|KU.AN|	𒆪𒀭	sux
guza	|KU.GAR|	𒆪𒃻	sux
guzza	|KU.GAR|	𒆪𒃻	sux
medda2	|KU.IDIM|	𒆪𒅂	sux
meddu2	|KU.IDIM|	𒆪𒅂	sux
meta2	|KU.IDIM|	𒆪𒅂	sux
metu2	|KU.IDIM|	𒆪𒅂	sux
midda2	|KU.IDIM|	𒆪𒅂	sux
middu2	|KU.IDIM|	𒆪𒅂	sux
mitta2	|KU.IDIM|	𒆪𒅂	sux
mittu2	|KU.IDIM|	𒆪𒅂	sux
mitum2	|KU.IDIM|	𒆪𒅂	sux
mita2	|KU.IDIM|	𒆪𒅂	sux
mitu2	|KU.IDIM|	𒆪𒅂	sux
zarahx	|KU.KI.SAG|	𒆪𒆠𒊕	sux
darax	|KU.GIŠ%GIŠ|	𒆪𒄒	sux
darix	|KU.GIŠ%GIŠ|	𒆪𒄒	sux
darux	|KU.GIŠ%GIŠ|	𒆪𒄒	sux
durux	|KU.GIŠ%GIŠ|	𒆪𒄒	sux
durunx	|KU.KU|	𒆪𒆪	sux
durunax	|KU.KU|	𒆪𒆪	sux
eh3	|KU.KU|	𒆪𒆪	sux
ehx	|KU.KU.KU|	𒆪𒆪𒆪	sux
ehehhe	|KU.KU.KU|	𒆪𒆪𒆪	sux
bula	|KU.NU|	𒆪𒉡	sux
merimer5	|KU&HI×AŠ₂.KU&HI×AŠ₂|	𒆫	sux
merimeri5	|KU&HI×AŠ₂.KU&HI×AŠ₂|	𒆫	sux
mermer5	|KU&HI×AŠ₂.KU&HI×AŠ₂|	𒆫	sux
mermeri5	|KU&HI×AŠ₂.KU&HI×AŠ₂|	𒆫	sux
LAK438	KU₃	𒆬	sux
ku3	KU₃	𒆬	sux
kug	KU₃	𒆬	sux
kuk	KU₃	𒆬	sux
qu5	KU₃	𒆬	sux
asax	|KU₃.AN|	𒆬𒀭	sux
asag	|KU₃.AN|	𒆬𒀭	sux
azag	|KU₃.AN|	𒆬𒀭	sux
azak	|KU₃.AN|	𒆬𒀭	sux
guckin	|KU₃.GI|	𒆬𒄀	sux
ku3-sig17	|KU₃.GI|	𒆬𒄀	sux
ku3-babbar	|KU₃.UD|	𒆬𒌓	sux
MZL87	KU₄	𒆭	sux
KWU636	KU₄	𒆭	sux
REC145	KU₄	𒆭	sux
hu2	KU₄	𒆭	sux
ku4	KU₄	𒆭	sux
kur9	KU₄	𒆭	sux
lilx	KU₄	𒆭	sux
LAK208~v	KU₄	𒆮	sux
KWU147~v	KU₄	𒆮	sux
ku4~v	KU₄	𒆮	sux
kur9~v	KU₄	𒆮	sux
LAK535	KU₇	𒆯	sux
LAK801	KU₇	𒆯	sux
MZL171	KU₇	𒆯	sux
bandilica	KU₇	𒆯	sux
bube	KU₇	𒆯	sux
daban	KU₇	𒆯	sux
dabacin	KU₇	𒆯	sux
ecdax	KU₇	𒆯	sux
ecqa	KU₇	𒆯	sux
gaml	KU₇	𒆯	sux
gurusa	KU₇	𒆯	sux
guruc2	KU₇	𒆯	sux
gurucda	KU₇	𒆯	sux
guructa	KU₇	𒆯	sux
guructi	KU₇	𒆯	sux
hirin2	KU₇	𒆯	sux
kakkala	KU₇	𒆯	sux
kakkuda	KU₇	𒆯	sux
kakkula	KU₇	𒆯	sux
kakkuca	KU₇	𒆯	sux
ku7	KU₇	𒆯	sux
kud5	KU₇	𒆯	sux
kukkuda	KU₇	𒆯	sux
kukula	KU₇	𒆯	sux
kukkuca	KU₇	𒆯	sux
kuruc	KU₇	𒆯	sux
kurucda	KU₇	𒆯	sux
kuc6	KU₇	𒆯	sux
candilimma	KU₇	𒆯	sux
cendilima	KU₇	𒆯	sux
cindilib	KU₇	𒆯	sux
cindilimma	KU₇	𒆯	sux
tubacin	KU₇	𒆯	sux
ku7-ku7	|KU₇.KU₇|	𒆯𒆯	sux
kukku	|KU₇.KU₇|	𒆯𒆯	sux
LAK12	KUL	𒆰	sux
MZL117	KUL	𒆰	sux
gu9	KUL	𒆰	sux
gul2	KUL	𒆰	sux
ku9	KUL	𒆰	sux
kul	KUL	𒆰	sux
kula	KUL	𒆰	sux
kulu	KUL	𒆰	sux
nu5	KUL	𒆰	sux
nujun	KUL	𒆰	sux
numu	KUL	𒆰	sux
numun	KUL	𒆰	sux
numun@d	KUL	𒆰	sux
qul	KUL	𒆰	sux
cabalbal	KUL	𒆰	sux
til8	KUL	𒆰	sux
zar4	KUL	𒆰	sux
zarax	KUL	𒆰	sux
zer	KUL	𒆰	sux
zir	KUL	𒆰	sux
ziri	KUL	𒆰	sux
tilx	KUL@g	𒆱	sux
LAK754	KUN	𒆲	sux
LAK26	KUN	𒆲	sux
MZL131	KUN	𒆲	sux
ku14	KUN	𒆲	sux
kun	KUN	𒆲	sux
kunu	KUN	𒆲	sux
megidax	KUN	𒆲	sux
...nunnam...	KUN	𒆲	sux
qun	KUN	𒆲	sux
MZL130~a	MAŠ₂	𒈧	sux
kun8~a	MAŠ₂	𒈧	sux
MZL578	KUR	𒆳	sux
LAK814	KUR	𒆳	sux
amma	KUR	𒆳	sux
anubu	KUR	𒆳	sux
ge21	KUR	𒆳	sux
gen3	KUR	𒆳	sux
gin3	KUR	𒆳	sux
gina3	KUR	𒆳	sux
gur16	KUR	𒆳	sux
kin3	KUR	𒆳	sux
kur	KUR	𒆳	sux
lad	KUR	𒆳	sux
lat	KUR	𒆳	sux
lata	KUR	𒆳	sux
lat	KUR	𒆳	sux
mad	KUR	𒆳	sux
mak0	KUR	𒆳	sux
mat	KUR	𒆳	sux
mat	KUR	𒆳	sux
nad	KUR	𒆳	sux
nat	KUR	𒆳	sux
nata	KUR	𒆳	sux
qur2	KUR	𒆳	sux
raman	KUR	𒆳	sux
ramanu	KUR	𒆳	sux
rammanu	KUR	𒆳	sux
racu	KUR	𒆳	sux
razu	KUR	𒆳	sux
sad	KUR	𒆳	sux
sat	KUR	𒆳	sux
sata	KUR	𒆳	sux
cad	KUR	𒆳	sux
cada	KUR	𒆳	sux
cadi	KUR	𒆳	sux
cadu	KUR	𒆳	sux
cahan	KUR	𒆳	sux
cat	KUR	𒆳	sux
cata	KUR	𒆳	sux
cat	KUR	𒆳	sux
zizanu	KUR	𒆳	sux
namru	|KUR.MUŠ₃@g.ZA.KI|	𒆳𒈽𒍝𒆠	sux
nenin	|KUR.SI.A.GA|	𒆳𒋛𒀀𒂵	sux
parsa	|KUR.TI|	𒆳𒋾	sux
gudibir2	|KUR@KUR|	𒆴	sux
lamhu	|KUR@KUR|	𒆴	sux
kuc9	KUŠU₂	𒆵	sux
kucu2	KUŠU₂	𒆵	sux
uh3	KUŠU₂	𒆵	sux
ucumgalx	|KWU089.GAL|	░░𒃲	sux
hirinx	KWU318	𒆶	sux
LAK663	LA	𒆷	sux
MZL89	LA	𒆷	sux
la	LA	𒆷	sux
cika	LA	𒆷	sux
cikx	LA	𒆷	sux
LAK766	LAGAB	𒆸	sux
ella2	LAGAB	𒆸	sux
ellag	LAGAB	𒆸	sux
ellaj	LAGAB	𒆸	sux
gil2	LAGAB	𒆸	sux
gili2	LAGAB	𒆸	sux
gir8	LAGAB	𒆸	sux
girenx	LAGAB	𒆸	sux
giri8	LAGAB	𒆸	sux
girim	LAGAB	𒆸	sux
girin	LAGAB	𒆸	sux
gud8	LAGAB	𒆸	sux
gur4	LAGAB	𒆸	sux
gurun3	LAGAB	𒆸	sux
hab	LAGAB	𒆸	sux
haba	LAGAB	𒆸	sux
hap	LAGAB	𒆸	sux
illag	LAGAB	𒆸	sux
kel	LAGAB	𒆸	sux
kele	LAGAB	𒆸	sux
kil	LAGAB	𒆸	sux
kili	LAGAB	𒆸	sux
kilib	LAGAB	𒆸	sux
kir3	LAGAB	𒆸	sux
kux	LAGAB	𒆸	sux
kur4	LAGAB	𒆸	sux
kuru4	LAGAB	𒆸	sux
lagab	LAGAB	𒆸	sux
lugud2	LAGAB	𒆸	sux
ni10	LAGAB	𒆸	sux
nigi2	LAGAB	𒆸	sux
nigin2	LAGAB	𒆸	sux
niji2	LAGAB	𒆸	sux
nijin2	LAGAB	𒆸	sux
nimen2	LAGAB	𒆸	sux
nin4	LAGAB	𒆸	sux
qer3	LAGAB	𒆸	sux
qel	LAGAB	𒆸	sux
qil	LAGAB	𒆸	sux
qir3	LAGAB	𒆸	sux
re3	LAGAB	𒆸	sux
rem	LAGAB	𒆸	sux
reme	LAGAB	𒆸	sux
ri3	LAGAB	𒆸	sux
rim	LAGAB	𒆸	sux
rin	LAGAB	𒆸	sux
sim4	LAGAB	𒆸	sux
sux	LAGAB	𒆸	sux
surx	LAGAB	𒆸	sux
tuku6	LAGAB	𒆸	sux
tukulx	LAGAB	𒆸	sux
tukur	LAGAB	𒆸	sux
tur6	LAGAB	𒆸	sux
LAK767	|LAGAB.LAGAB|	𒆸𒆸	sux
banx	|LAGAB.LAGAB|	𒆸𒆸	sux
garadin5	|LAGAB.LAGAB|	𒆸𒆸	sux
ichara3	|LAGAB.LAGAB|	𒆸𒆸	sux
karadin5	|LAGAB.LAGAB|	𒆸𒆸	sux
kel3	|LAGAB.LAGAB|	𒆸𒆸	sux
kil3	|LAGAB.LAGAB|	𒆸𒆸	sux
kilax	|LAGAB.LAGAB|	𒆸𒆸	sux
kilux	|LAGAB.LAGAB|	𒆸𒆸	sux
kili3	|LAGAB.LAGAB|	𒆸𒆸	sux
kilib3	|LAGAB.LAGAB|	𒆸𒆸	sux
kin4	|LAGAB.LAGAB|	𒆸𒆸	sux
ni6	|LAGAB.LAGAB|	𒆸𒆸	sux
niggix	|LAGAB.LAGAB|	𒆸𒆸	sux
nigginaku	|LAGAB.LAGAB|	𒆸𒆸	sux
nigi	|LAGAB.LAGAB|	𒆸𒆸	sux
nigin	|LAGAB.LAGAB|	𒆸𒆸	sux
nijin	|LAGAB.LAGAB|	𒆸𒆸	sux
nimenx	|LAGAB.LAGAB|	𒆸𒆸	sux
nin3	|LAGAB.LAGAB|	𒆸𒆸	sux
nini	|LAGAB.LAGAB|	𒆸𒆸	sux
ninni2	|LAGAB.LAGAB|	𒆸𒆸	sux
rin3	|LAGAB.LAGAB|	𒆸𒆸	sux
mud4	|LAGAB.U.KAK|	𒆸𒌋𒆕	sux
burux	|4×LAGAB|	𒇫	sux
gurux	|4×LAGAB|	𒇫	sux
gurun4	|4×LAGAB|	𒇫	sux
LAK785	|LAGAB×A|	𒆹	sux
a9	|LAGAB×A|	𒆹	sux
a)a3	|LAGAB×A|	𒆹	sux
abbar	|LAGAB×A|	𒆹	sux
abbarax	|LAGAB×A|	𒆹	sux
ablal2	|LAGAB×A|	𒆹	sux
aia4	|LAGAB×A|	𒆹	sux
ambar	|LAGAB×A|	𒆹	sux
ambara	|LAGAB×A|	𒆹	sux
anbar	|LAGAB×A|	𒆹	sux
as4	|LAGAB×A|	𒆹	sux
aslum	|LAGAB×A|	𒆹	sux
acte2	|LAGAB×A|	𒆹	sux
aya4	|LAGAB×A|	𒆹	sux
bugin	|LAGAB×A|	𒆹	sux
bunij	|LAGAB×A|	𒆹	sux
bunin	|LAGAB×A|	𒆹	sux
elamkuc4	|LAGAB×A|	𒆹	sux
ellamkuc4	|LAGAB×A|	𒆹	sux
engurx	|LAGAB×A|	𒆹	sux
gunin2	|LAGAB×A|	𒆹	sux
ix	|LAGAB×A|	𒆹	sux
idx	|LAGAB×A|	𒆹	sux
kunin2	|LAGAB×A|	𒆹	sux
nammax	|LAGAB×A|	𒆹	sux
nammux	|LAGAB×A|	𒆹	sux
puginx	|LAGAB×A|	𒆹	sux
sug	|LAGAB×A|	𒆹	sux
sugix	|LAGAB×A|	𒆹	sux
suk	|LAGAB×A|	𒆹	sux
suq	|LAGAB×A|	𒆹	sux
cuk3	|LAGAB×A|	𒆹	sux
umun11	|LAGAB×A|	𒆹	sux
zikumx	|LAGAB×A|	𒆹	sux
zug	|LAGAB×A|	𒆹	sux
zuk	|LAGAB×A|	𒆹	sux
zuq	|LAGAB×A|	𒆹	sux
bunijx~a	|A.LAGAB×A|	𒀀𒆹	sux
buninx~a	|A.LAGAB×A|	𒀀𒆹	sux
bugin2~b	|LAGAB×GAR|	𒇅	sux
bunij2~b	|LAGAB×GAR|	𒇅	sux
bunin2~b	|LAGAB×GAR|	𒇅	sux
bugin3~c	|LAGAB×ME|	𒇘	sux
bunin3~c	|LAGAB×ME|	𒇘	sux
bugin4~d	|LAGAB×(U.A)|	𒇦	sux
bunin4~d	|LAGAB×(U.A)|	𒇦	sux
LAK768~e	|LAGAB×HAL|	𒇉	sux
bunig3~e	|LAGAB×HAL|	𒇉	sux
bunij3~e	|LAGAB×HAL|	𒇉	sux
kunin~f	|LAGAB×KUL|	𒇒	sux
LAK797~g	A	𒀀	sux
MZL839~g	A	𒀀	sux
bunijx~g	A	𒀀	sux
as4-lum	|LAGAB×A.LUM|	𒆹𒈝	sux
suluhu4	|LAGAB×A.LUM|	𒆹𒈝	sux
sulumhi4	|LAGAB×A.LUM|	𒆹𒈝	sux
zuluhu4	|LAGAB×A.LUM|	𒆹𒈝	sux
inda2	|LAGAB×A.TAR|	𒆹𒋻	sux
edakua2	|LAGAB×(A.DA.HA)|	𒆺	sux
agar3	|LAGAB×(A.GAR)|	𒆻	sux
ablal	|LAGAB×(A.LAL)|	𒆼	sux
kinbur	|LAGAB×(A.LAL)|	𒆼	sux
gala4	|LAGAB×AL|	𒆽	sux
kala4	|LAGAB×AL|	𒆽	sux
LAK769	|LAGAB×AN|	𒆾	sux
ama6	|LAGAB×AN|	𒆾	sux
gigir	|LAGAB×BAD|	𒇀	sux
gigira	|LAGAB×BAD|	𒇀	sux
pu6	|LAGAB×BAD|	𒇀	sux
tul8	|LAGAB×BAD|	𒇀	sux
kunin3	|LAGAB×BI|	𒇁	sux
gala11	|LAGAB×DAR|	𒇂	sux
kala10	|LAGAB×DAR|	𒇂	sux
sidug	|LAGAB×DAR|	𒇂	sux
sidugga	|LAGAB×DAR|	𒇂	sux
bara5	|LAGAB×EN|	𒇃	sux
para5	|LAGAB×EN|	𒇃	sux
sidug2	|LAGAB×GA|	𒇄	sux
siduga2	|LAGAB×GA|	𒇄	sux
sidugga2	|LAGAB×GA|	𒇄	sux
abbarx	|LAGAB×GAR|	𒇅	sux
ambarx	|LAGAB×GAR|	𒇅	sux
asx	|LAGAB×GAR|	𒇅	sux
aslumx	|LAGAB×GAR|	𒇅	sux
actex	|LAGAB×GAR|	𒇅	sux
ayax	|LAGAB×GAR|	𒇅	sux
bugin2	|LAGAB×GAR|	𒇅	sux
bunij2	|LAGAB×GAR|	𒇅	sux
bunin2	|LAGAB×GAR|	𒇅	sux
delen3	|LAGAB×GAR|	𒇅	sux
delena3	|LAGAB×GAR|	𒇅	sux
dilim5	|LAGAB×GAR|	𒇅	sux
dilin3	|LAGAB×GAR|	𒇅	sux
dilina3	|LAGAB×GAR|	𒇅	sux
duruna4	|LAGAB×GAR|	𒇅	sux
ellamkucx	|LAGAB×GAR|	𒇅	sux
guninx	|LAGAB×GAR|	𒇅	sux
immindu2	|LAGAB×GAR|	𒇅	sux
inda4	|LAGAB×GAR|	𒇅	sux
kuninx	|LAGAB×GAR|	𒇅	sux
ninda4	|LAGAB×GAR|	𒇅	sux
nindu	|LAGAB×GAR|	𒇅	sux
ninindu	|LAGAB×GAR|	𒇅	sux
sugx	|LAGAB×GAR|	𒇅	sux
tinur3	|LAGAB×GAR|	𒇅	sux
umunx	|LAGAB×GAR|	𒇅	sux
zugx	|LAGAB×GAR|	𒇅	sux
)u3	|LAGAB×GUD|	𒇆	sux
dabx	|LAGAB×GUD|	𒇆	sux
dib5	|LAGAB×GUD|	𒇆	sux
gana5	|LAGAB×GUD|	𒇆	sux
ganam5	|LAGAB×GUD|	𒇆	sux
cara4	|LAGAB×GUD|	𒇆	sux
curim3	|LAGAB×GUD|	𒇆	sux
curu3	|LAGAB×GUD|	𒇆	sux
curum3	|LAGAB×GUD|	𒇆	sux
curun3	|LAGAB×GUD|	𒇆	sux
u)3	|LAGAB×GUD|	𒇆	sux
ua	|LAGAB×GUD|	𒇆	sux
wax	|LAGAB×GUD|	𒇆	sux
u)a	|LAGAB×(GUD.GUD).A|	𒇇𒀀	sux
u)i	|LAGAB×(GUD.GUD).A|	𒇇𒀀	sux
u)u	|LAGAB×(GUD.GUD).A|	𒇇𒀀	sux
usduha	|LAGAB×GUD.LU.HI.A|	𒇆𒇻𒄭𒀀	sux
uzduha	|LAGAB×GUD.LU.HI.A|	𒇆𒇻𒄭𒀀	sux
dibx	|LAGAB×(GUD.GUD)|	𒇇	sux
gana4	|LAGAB×(GUD.GUD)|	𒇇	sux
ganam4	|LAGAB×(GUD.GUD)|	𒇇	sux
gayayu	|LAGAB×(GUD.GUD)|	𒇇	sux
lahar	|LAGAB×(GUD.GUD)|	𒇇	sux
lahrax	|LAGAB×(GUD.GUD)|	𒇇	sux
lahru	|LAGAB×(GUD.GUD)|	𒇇	sux
lahrum	|LAGAB×(GUD.GUD)|	𒇇	sux
cerba	|LAGAB×(GUD.GUD)|	𒇇	sux
curim	|LAGAB×(GUD.GUD)|	𒇇	sux
curu	|LAGAB×(GUD.GUD)|	𒇇	sux
curum	|LAGAB×(GUD.GUD)|	𒇇	sux
curun	|LAGAB×(GUD.GUD)|	𒇇	sux
u8	|LAGAB×(GUD.GUD)|	𒇇	sux
ua	|LAGAB×(GUD.GUD)|	𒇇	sux
us5	|LAGAB×(GUD.GUD)|	𒇇	sux
uz5	|LAGAB×(GUD.GUD)|	𒇇	sux
wax	|LAGAB×(GUD.GUD)|	𒇇	sux
LAK784a	|LAGAB×HA|	𒇈	sux
elamkuc3	|LAGAB×HA|	𒇈	sux
ellamkuc3	|LAGAB×HA|	𒇈	sux
LAK768	|LAGAB×HAL|	𒇉	sux
angur	|LAGAB×HAL|	𒇉	sux
bunig3	|LAGAB×HAL|	𒇉	sux
bunij3	|LAGAB×HAL|	𒇉	sux
engur	|LAGAB×HAL|	𒇉	sux
gilugu	|LAGAB×HAL|	𒇉	sux
gur22	|LAGAB×HAL|	𒇉	sux
ex	|LAGAB×HAL|	𒇉	sux
i8	|LAGAB×HAL|	𒇉	sux
id3	|LAGAB×HAL|	𒇉	sux
lammu6	|LAGAB×HAL|	𒇉	sux
namma	|LAGAB×HAL|	𒇉	sux
nammu	|LAGAB×HAL|	𒇉	sux
zikum	|LAGAB×HAL|	𒇉	sux
zikumux	|LAGAB×HAL|	𒇉	sux
ix	|LAGAB×HAL.A|	𒇉𒀀	sux
umun6	|LAGAB×HI×NUN|	𒇊	sux
bun	|LAGAB×IM|	𒇌	sux
delen	|LAGAB×IM|	𒇌	sux
delena	|LAGAB×IM|	𒇌	sux
dilim	|LAGAB×IM|	𒇌	sux
dilim3	|LAGAB×IM|	𒇌	sux
dilin	|LAGAB×IM|	𒇌	sux
dilina	|LAGAB×IM|	𒇌	sux
duruna2	|LAGAB×IM|	𒇌	sux
elamkuc	|LAGAB×IM|	𒇌	sux
ellamkuc	|LAGAB×IM|	𒇌	sux
ilamma	|LAGAB×IM|	𒇌	sux
illamma	|LAGAB×IM|	𒇌	sux
immindu	|LAGAB×IM|	𒇌	sux
inda5	|LAGAB×IM|	𒇌	sux
ninda3	|LAGAB×IM|	𒇌	sux
nindu2	|LAGAB×IM|	𒇌	sux
ninindu2	|LAGAB×IM|	𒇌	sux
tinur	|LAGAB×IM|	𒇌	sux
tinuru	|LAGAB×IM|	𒇌	sux
tunur	|LAGAB×IM|	𒇌	sux
ellamkucx	|LAGAB×(IM.HA)|	𒇍	sux
elamkucx	|LAGAB×(IM.LU)|	𒇎	sux
ellamkucx	|LAGAB×(IM.LU)|	𒇎	sux
gala5	|LAGAB×KI|	𒇏	sux
kala5	|LAGAB×KI|	𒇏	sux
ablalx	|LAGAB×KIN|	𒇐	sux
gukin	|LAGAB×KIN|	𒇐	sux
udda	|LAGAB×KIN|	𒇐	sux
dagrim	|LAGAB×KU₃|	𒇑	sux
dagrin	|LAGAB×KU₃|	𒇑	sux
garim	|LAGAB×KU₃|	𒇑	sux
garin	|LAGAB×KU₃|	𒇑	sux
jarim	|LAGAB×KU₃|	𒇑	sux
jarin	|LAGAB×KU₃|	𒇑	sux
tagrimx	|LAGAB×KU₃|	𒇑	sux
tagrinx	|LAGAB×KU₃|	𒇑	sux
esir2	|LAGAB×KUL|	𒇒	sux
kunin	|LAGAB×KUL|	𒇒	sux
cukumx	|LAGAB×KUL|	𒇒	sux
esirha	|LAGAB×(KUL.HI.A)|	𒇓	sux
esirhia	|LAGAB×(KUL.HI.A)|	𒇓	sux
niginx	|LAGAB×LAGAB|	𒇔	sux
gigir3	|LAGAB×AŠ@t|	𒇕	sux
akan3	|LAGAB×LU|	𒇖	sux
akkan3	|LAGAB×LU|	𒇖	sux
elamkuc2	|LAGAB×LU|	𒇖	sux
ellamkuc2	|LAGAB×LU|	𒇖	sux
bara9	|LAGAB×LUL|	𒇗	sux
irib2	|LAGAB×LUL|	𒇗	sux
para9	|LAGAB×LUL|	𒇗	sux
bara6	|LAGAB×(ME.EN)|	𒇙	sux
men4	|LAGAB×(ME.EN)|	𒇙	sux
para6	|LAGAB×(ME.EN)|	𒇙	sux
muccagana	|LAGAB×MUŠ|	𒇚	sux
udub	|LAGAB×NE|	𒇛	sux
LAK782	|LAGAB×IGI@g|	𒇋	sux
agar2	|LAGAB×IGI@g|	𒇋	sux
bara7	|LAGAB×IGI@g|	𒇋	sux
immax	|LAGAB×IGI@g|	𒇋	sux
para7	|LAGAB×IGI@g|	𒇋	sux
cara2	|LAGAB×IGI@g|	𒇋	sux
bu14	|LAGAB×SUM|	𒇡	sux
bul5	|LAGAB×SUM|	𒇡	sux
buru16	|LAGAB×SUM|	𒇡	sux
sar6	|LAGAB×SUM|	𒇡	sux
sur8	|LAGAB×SUM|	𒇡	sux
cerim2	|LAGAB×SUM|	𒇡	sux
s,ar	|LAGAB×SUM|	𒇡	sux
s,ara	|LAGAB×SUM|	𒇡	sux
zal2	|LAGAB×SUM|	𒇡	sux
zar	|LAGAB×SUM|	𒇡	sux
zara	|LAGAB×SUM|	𒇡	sux
zarih	|LAGAB×SUM|	𒇡	sux
zur4	|LAGAB×SUM|	𒇡	sux
cerimsur	|LAGAB×(ŠE.SUM)|	𒇜	sux
cerinsur	|LAGAB×(ŠE.SUM)|	𒇜	sux
mex	|LAGAB×(ŠITA.GIŠ.ERIN₂)|	𒇝	sux
sagdudux	|LAGAB×(ŠITA.GIŠ.ERIN₂)|	𒇝	sux
me9	|LAGAB×(ŠITA@t.GIŠ)|	𒇞	sux
muccagana2	|LAGAB×(ŠITA@t.GIŠ)|	𒇞	sux
sagdudu	|LAGAB×(ŠITA@t.GIŠ)|	𒇞	sux
cu5	|LAGAB×ŠU₂|	𒇟	sux
cuc5	|LAGAB×ŠU₂|	𒇟	sux
cu6	|LAGAB×(ŠU₂.ŠU₂)|	𒇠	sux
cuc6	|LAGAB×(ŠU₂.ŠU₂)|	𒇠	sux
sidugax	|LAGAB×TAG|	𒇢	sux
bara8	|LAGAB×TAK₄|	𒇣	sux
ninmuc	|LAGAB×TAK₄|	𒇣	sux
para8	|LAGAB×TAK₄|	𒇣	sux
cara3	|LAGAB×TAK₄|	𒇣	sux
curu2	|LAGAB×TAK₄|	𒇣	sux
curun2	|LAGAB×TAK₄|	𒇣	sux
cedur	|LAGAB×(TE.A.SU.NA)|	𒇤	sux
bu4	|LAGAB×U|	𒇥	sux
bu6	|LAGAB×U|	𒇥	sux
dul2	|LAGAB×U|	𒇥	sux
gala3	|LAGAB×U|	𒇥	sux
gigir2	|LAGAB×U|	𒇥	sux
gigira2	|LAGAB×U|	𒇥	sux
hab2	|LAGAB×U|	𒇥	sux
hap2	|LAGAB×U|	𒇥	sux
kala3	|LAGAB×U|	𒇥	sux
pu2	|LAGAB×U|	𒇥	sux
tukurx	|LAGAB×U|	𒇥	sux
tul2	|LAGAB×U|	𒇥	sux
tul	|LAGAB×U|	𒇥	sux
ub4	|LAGAB×U|	𒇥	sux
ablal3	|LAGAB×(U.A)|	𒇦	sux
amah	|LAGAB×(U.A)|	𒇦	sux
bugin4	|LAGAB×(U.A)|	𒇦	sux
bunin4	|LAGAB×(U.A)|	𒇦	sux
humuh	|LAGAB×(U.A)|	𒇦	sux
umah	|LAGAB×(U.A)|	𒇦	sux
umuh	|LAGAB×(U.A)|	𒇦	sux
umun5	|LAGAB×(U.A)|	𒇦	sux
bu5	|LAGAB×(U.U.U)|	𒇧	sux
bul	|LAGAB×(U.U.U)|	𒇧	sux
bur10	|LAGAB×(U.U.U)|	𒇧	sux
burux	|LAGAB×(U.U.U)|	𒇧	sux
nenna2	|LAGAB×(U.U.U)|	𒇧	sux
nenni2	|LAGAB×(U.U.U)|	𒇧	sux
ninna2	|LAGAB×(U.U.U)|	𒇧	sux
ninni4	|LAGAB×(U.U.U)|	𒇧	sux
ninnim4	|LAGAB×(U.U.U)|	𒇧	sux
ninnux	|LAGAB×(U.U.U)|	𒇧	sux
nussu	|LAGAB×(U.U.U)|	𒇧	sux
pul	|LAGAB×(U.U.U)|	𒇧	sux
tu13	|LAGAB×(U.U.U)|	𒇧	sux
tug4	|LAGAB×(U.U.U)|	𒇧	sux
tuk4	|LAGAB×(U.U.U)|	𒇧	sux
tuku4	|LAGAB×(U.U.U)|	𒇧	sux
zansur	|LAGAB×(U.U.U)|	𒇧	sux
bu5-bu5	|LAGAB×(U.U.U).LAGAB×(U.U.U)|	𒇧𒇧	sux
bubux	|LAGAB×(U.U.U).LAGAB×(U.U.U)|	𒇧𒇧	sux
bubbu	|LAGAB×(U.U.U).LAGAB×(U.U.U)|	𒇧𒇧	sux
nenna	|LAGAB×(U.U.U).LAGAB×(U.U.U)|	𒇧𒇧	sux
nenni	|LAGAB×(U.U.U).LAGAB×(U.U.U)|	𒇧𒇧	sux
nin7	|LAGAB×(U.U.U).LAGAB×(U.U.U)|	𒇧𒇧	sux
ninna	|LAGAB×(U.U.U).LAGAB×(U.U.U)|	𒇧𒇧	sux
ninnu2	|LAGAB×(U.U.U).LAGAB×(U.U.U)|	𒇧𒇧	sux
tutke	|LAGAB×(U.U.U).LAGAB×(U.U.U)|	𒇧𒇧	sux
tutki	|LAGAB×(U.U.U).LAGAB×(U.U.U)|	𒇧𒇧	sux
tutku	|LAGAB×(U.U.U).LAGAB×(U.U.U)|	𒇧𒇧	sux
ugra	|LAGAB×(U₂.AŠ)|	𒇨	sux
ugri	|LAGAB×(U₂.AŠ)|	𒇨	sux
ucera	|LAGAB×(U₂.AŠ)|	𒇨	sux
uceri	|LAGAB×(U₂.AŠ)|	𒇨	sux
umun12	|LAGAB×UD|	𒇩	sux
umuna12	|LAGAB×UD|	𒇩	sux
nigin11	|LAGAB×UŠ|	𒇪	sux
nimenx	|LAGAB×UŠ|	𒇪	sux
LAK306	LAGAR	𒇬	sux
lagal	LAGAR	𒇬	sux
lagar	LAGAR	𒇬	sux
nagal	LAGAR	𒇬	sux
LAK303	|LAGAR×ŠE|	𒇭	sux
su7	|LAGAR×ŠE|	𒇭	sux
sug8	|LAGAR×ŠE|	𒇭	sux
sul4	|LAGAR×ŠE|	𒇭	sux
sur12	|LAGAR×ŠE|	𒇭	sux
sura12	|LAGAR×ŠE|	𒇭	sux
...bun	|LAGAR×(ŠE.SUM)|	𒇮	sux
lugud4	|LAGAR×(ŠE.SUM)|	𒇮	sux
suhirim	|LAGAR×(ŠE.SUM)|	𒇮	sux
suhirin	|LAGAR×(ŠE.SUM)|	𒇮	sux
LAK302	LAGAR@g	𒇯	sux
du6	LAGAR@g	𒇯	sux
dul6	LAGAR@g	𒇯	sux
til2	LAGAR@g	𒇯	sux
tu21	LAGAR@g	𒇯	sux
tul5	LAGAR@g	𒇯	sux
tul3	LAGAR@g	𒇯	sux
e11	|LAGAR@g.DU|	𒇯𒁺	sux
ed3	|LAGAR@g.DU|	𒇯𒁺	sux
gigir4	|LAGAR@g.DU|	𒇯𒁺	sux
e12	|LAGAR@g.DU@s|	𒇯𒁽	sux
ed4	|LAGAR@g.DU@s|	𒇯𒁽	sux
sumunda	|LAGAR@g&LAGAR@g.ŠE|	𒇰	sux
cumunx	|LAGAR@g&LAGAR@g.ŠE|	𒇰	sux
cumunda	|LAGAR@g&LAGAR@g.ŠE|	𒇰	sux
LAK756	LAL	𒇲	sux
la2	LAL	𒇲	sux
lal	LAL	𒇲	sux
lux	LAL	𒇲	sux
sur5	LAL	𒇲	sux
suru5	LAL	𒇲	sux
curx	LAL	𒇲	sux
curux	LAL	𒇲	sux
zur5	LAL	𒇲	sux
zuru5	LAL	𒇲	sux
la)u7	|LAL.KAK|	𒇲𒆕	sux
lal)u7	|LAL.KAK|	𒇲𒆕	sux
nanga2	|LAL.LAGAB|	𒇲𒆸	sux
nigin7	|LAL.LAGAB|	𒇲𒆸	sux
nimem3	|LAL.LAGAB|	𒇲𒆸	sux
surx	|LAL.LAGAB|	𒇲𒆸	sux
cur5	|LAL.LAGAB|	𒇲𒆸	sux
usar4	|LAL.LAGAB|	𒇲𒆸	sux
usur4	|LAL.LAGAB|	𒇲𒆸	sux
ucar4	|LAL.LAGAB|	𒇲𒆸	sux
ucur4	|LAL.LAGAB|	𒇲𒆸	sux
LAK758	|LAL.NI|	𒇲𒉌	sux
la)u6	|LAL.NI|	𒇲𒉌	sux
lal)u6	|LAL.NI|	𒇲𒉌	sux
nanga4	|LAL.SAR|	𒇲𒊬	sux
nigin9	|LAL.SAR|	𒇲𒊬	sux
nijin9	|LAL.SAR|	𒇲𒊬	sux
nimen5	|LAL.SAR|	𒇲𒊬	sux
usar2	|LAL.SAR|	𒇲𒊬	sux
ucar2	|LAL.SAR|	𒇲𒊬	sux
ucur2	|LAL.SAR|	𒇲𒊬	sux
LAK760	LAL₂	𒇳	sux
kurnun	LAL₂	𒇳	sux
la5	LAL₂	𒇳	sux
la)u	LAL₂	𒇳	sux
lal-lal	LAL₂	𒇳	sux
lal2	LAL₂	𒇳	sux
lal)u	LAL₂	𒇳	sux
lalla	LAL₂	𒇳	sux
lallal	LAL₂	𒇳	sux
papnun	LAL₂	𒇳	sux
la)u5	|LAL₂.A|	𒇳𒀀	sux
lal)u5	|LAL₂.A|	𒇳𒀀	sux
uku5	|LAL₂.DU.DU|	𒇳𒁺𒁺	sux
ukur4	|LAL₂.DU.DU|	𒇳𒁺𒁺	sux
halba4	|LAL₂.HAL|	𒇳𒄬	sux
halbi4	|LAL₂.HAL|	𒇳𒄬	sux
halbu4	|LAL₂.HAL|	𒇳𒄬	sux
nanga	|LAL₂.LAGAB|	𒇳𒆸	sux
nigin5	|LAL₂.LAGAB|	𒇳𒆸	sux
nijin5	|LAL₂.LAGAB|	𒇳𒆸	sux
nimen	|LAL₂.LAGAB|	𒇳𒆸	sux
cur6	|LAL₂.LAGAB|	𒇳𒆸	sux
usar3	|LAL₂.LAGAB|	𒇳𒆸	sux
ucar3	|LAL₂.LAGAB|	𒇳𒆸	sux
ucur3	|LAL₂.LAGAB|	𒇳𒆸	sux
surx	|LAL₂.TUG₂|	𒇳𒌆	sux
ucurx	|LAL₂.TUG₂|	𒇳𒌆	sux
la)ux	|LAL₂.U|	𒇳𒌋	sux
halba5	|LAL₂.URU×MIN|	𒇳𒍇	sux
halbi5	|LAL₂.URU×MIN|	𒇳𒍇	sux
halbu5	|LAL₂.URU×MIN|	𒇳𒍇	sux
halpiax	|LAL₂.URU×MIN|	𒇳𒍇	sux
uku2	|LAL₂.DU|	𒇳𒁺	sux
ukur3	|LAL₂.DU|	𒇳𒁺	sux
halpix	|LAL₂.HAL|	𒇳𒄬	sux
halpiax	|LAL₂.HAL|	𒇳𒄬	sux
la)u4	|LAL₂.KAK|	𒇳𒆕	sux
lal)u4	|LAL₂.KAK|	𒇳𒆕	sux
la)u3	|LAL₂.NI|	𒇳𒉌	sux
lal)u3	|LAL₂.NI|	𒇳𒉌	sux
nanga3	|LAL₂.SAR|	𒇳𒊬	sux
nigin8	|LAL₂.SAR|	𒇳𒊬	sux
nijin8	|LAL₂.SAR|	𒇳𒊬	sux
nimen4	|LAL₂.SAR|	𒇳𒊬	sux
cur4	|LAL₂.SAR|	𒇳𒊬	sux
usar	|LAL₂.SAR|	𒇳𒊬	sux
usur	|LAL₂.SAR|	𒇳𒊬	sux
ucar	|LAL₂.SAR|	𒇳𒊬	sux
ucur	|LAL₂.SAR|	𒇳𒊬	sux
halpi	|LAL₂.URU×MIN|	𒇳𒍇	sux
halpia	|LAL₂.URU×MIN|	𒇳𒍇	sux
LAK189	LAM	𒇴	sux
ecx	LAM	𒇴	sux
la12	LAM	𒇴	sux
lam	LAM	𒇴	sux
lama	LAM	𒇴	sux
lammax	LAM	𒇴	sux
lim3	LAM	𒇴	sux
lugx	LAM	𒇴	sux
LAK190	|LAM×KUR|	𒇵	sux
arad3	|LAM×KUR|	𒇵	sux
ec22	|LAM×KUR|	𒇵	sux
ecux	|LAM×KUR|	𒇵	sux
ic11	|LAM×KUR|	𒇵	sux
lam7	|LAM×KUR|	𒇵	sux
arata	|LAM×(KUR.RU)|	𒇶	sux
aratta	|LAM×(KUR.RU)|	𒇶	sux
arata	|LAM×(KUR.RU)|	𒇶	sux
curipak2	|LAM×(KUR.RU)|	𒇶	sux
curippak2	|LAM×(KUR.RU)|	𒇶	sux
curupak2	|LAM×(KUR.RU)|	𒇶	sux
curuppak2	|LAM×(KUR.RU)|	𒇶	sux
cubax	|LAM.SAG|	𒇴𒊕	sux
LAK206	LI	𒇷	sux
MZL85	LI	𒇷	sux
en3	LI	𒇷	sux
gub2	LI	𒇷	sux
gup2	LI	𒇷	sux
le	LI	𒇷	sux
li	LI	𒇷	sux
ni8	LI	𒇷	sux
nu9	LI	𒇷	sux
LAK170~a	ŠA	𒊭	sux
MZL566~a	ŠA	𒊭	sux
en8~a	ŠA	𒊭	sux
li5~a	ŠA	𒊭	sux
LAK208	LIL	𒇸	sux
il9	LIL	𒇸	sux
kurx	LIL	𒇸	sux
lil	LIL	𒇸	sux
sukux	LIL	𒇸	sux
4(dic)@v	LIMMU	𒐼	sux
4(dic@c)@v	LIMMU	𒐼	sux
lammu	LIMMU	𒐼	sux
limmu	LIMMU	𒐼	sux
limu	LIMMU	𒐼	sux
LAK91	LIMMU₂	𒇹	sux
4(dic)@v~b	LIMMU₂	𒇹	sux
4(dic@c)@v~b	LIMMU₂	𒇹	sux
arba	LIMMU₂	𒇹	sux
arrap	LIMMU₂	𒇹	sux
erba	LIMMU₂	𒇹	sux
erbe	LIMMU₂	𒇹	sux
lam4	LIMMU₂	𒇹	sux
lammu2	LIMMU₂	𒇹	sux
lim2	LIMMU₂	𒇹	sux
limmu2	LIMMU₂	𒇹	sux
limu2	LIMMU₂	𒇹	sux
4(dic@v)	LIMMU	𒐾	sux
4(dic@v@c)	LIMMU	𒐾	sux
limmux	LIMMU	𒐾	sux
4(dic@v)	LIMMU	𒐿	sux
4(dic@v@c)	LIMMU	𒐿	sux
limmux	LIMMU	𒐿	sux
LAK279	LIŠ	𒇺	sux
del2	LIŠ	𒇺	sux
dili2	LIŠ	𒇺	sux
dilim2	LIŠ	𒇺	sux
li12	LIŠ	𒇺	sux
lih4	LIŠ	𒇺	sux
lis	LIŠ	𒇺	sux
lic	LIŠ	𒇺	sux
liz	LIŠ	𒇺	sux
mal4	LIŠ	𒇺	sux
eze	LU	𒇻	sux
lu	LU	𒇻	sux
lug	LU	𒇻	sux
nu12	LU	𒇻	sux
si6	LU	𒇻	sux
udu	LU	𒇻	sux
ugnimx	|LU.EŠ₂.GAR.KI|	𒇻𒂠𒃻𒆠	sux
guggal	|LU.HUL₂|	𒇻	sux
gukkal	|LU.HUL₂|	𒇻	sux
kungal	|LU.HUL₂|	𒇻	sux
zarah2	|LU.KI.KAK|	𒇻𒆠𒆕	sux
cimacki	|LU.SU|	𒇻𒋢	sux
cimacki2	|LU.SU.A|	𒇻𒋢𒀀	sux
ad3	|LU×BAD|	𒇼	sux
adda2	|LU×BAD|	𒇼	sux
LAK337	LU₂	𒇽	sux
addax	LU₂	𒇽	sux
dux	LU₂	𒇽	sux
girix	LU₂	𒇽	sux
lu2	LU₂	𒇽	sux
na6	LU₂	𒇽	sux
ruh2	LU₂	𒇽	sux
ca11	LU₂	𒇽	sux
cagax	LU₂	𒇽	sux
cajax	LU₂	𒇽	sux
gal10	|LU₂.DIŠ|	𒇽𒁹	sux
gala10	|LU₂.DIŠ|	𒇽𒁹	sux
daparax	|LU₂.EN|	𒇽𒂗	sux
adaminx	|LU₂.LU₂|	𒇽𒇽	sux
gigamx	|LU₂.LU₂|	𒇽𒇽	sux
inbirx	|LU₂.LU₂|	𒇽𒇽	sux
daparu	|LU₂.ME.EN|	𒇽𒈨𒂗	sux
saparu	|LU₂.ME.EN|	𒇽𒈨𒂗	sux
daparax	|4×LU₂|	𒈔	sux
kapara3	|4×LU₂|	𒈔	sux
karacx	|4×LU₂|	𒈔	sux
pagra3	|4×LU₂|	𒈔	sux
dubal5	|LU₂×AL|	𒇾	sux
LAK344	|LU₂×BAD|	𒇿	sux
ad6	|LU₂×BAD|	𒇿	sux
adax	|LU₂×BAD|	𒇿	sux
adda	|LU₂×BAD|	𒇿	sux
at6	|LU₂×BAD|	𒇿	sux
erx	|LU₂×EŠ₂|	𒈀	sux
erex	|LU₂×EŠ₂|	𒈀	sux
[...]	|LU₂×EŠ₂.LAL|	𒈀𒇲	sux
ecela	|LU₂×EŠ₂.LAL|	𒈀𒇲	sux
ecelal	|LU₂×EŠ₂.LAL|	𒈀𒇲	sux
...id	|LU₂×EŠ₂.LAL|	𒈀𒇲	sux
irx	|LU₂×EŠ₂.LAL|	𒈀𒇲	sux
er13	|LU₂×EŠ₂@t|	𒈁	sux
ere13	|LU₂×EŠ₂@t|	𒈁	sux
eri13	|LU₂×EŠ₂@t|	𒈁	sux
ir13	|LU₂×EŠ₂@t|	𒈁	sux
hec5	|LU₂×GAN₂@t|	𒈂	sux
caga	|LU₂×GAN₂@t|	𒈂	sux
caja	|LU₂×GAN₂@t|	𒈂	sux
ce29	|LU₂×GAN₂@t|	𒈂	sux
kama5	|LU₂×HI×BAD|	𒈃	sux
...Ac	|LU₂×IM|	𒈄	sux
dubal3	|LU₂×KAD₂|	𒈅	sux
dubal4~a	|LU₂×KAD₃|	𒈆	sux
zanabal2	|LU₂×(KAD₃.AŠ)|	𒈇	sux
dubal6	|LU₂×KI|	𒈈	sux
gurud2	|LU₂×KI|	𒈈	sux
zanabal	|LU₂×(LA.AŠ)|	𒈉	sux
dinig3	|LU₂×LAGAB|	𒈊	sux
eclug	|LU₂×LAGAB|	𒈊	sux
har3	|LU₂×LAGAB|	𒈊	sux
hara3	|LU₂×LAGAB|	𒈊	sux
teclug	|LU₂×LAGAB|	𒈊	sux
/teclug/	|LU₂×LAGAB|	𒈊	sux
dinig2	|LU₂×(ME.EN)|	𒈋	sux
du14	|LU₂×NE|	𒈌	sux
...tallu	|LU₂×NU|	𒈍	sux
zanabal3	|LU₂×(SI.AŠ)|	𒈎	sux
...Ac	|LU₂×(SIK₂.BU)|	𒈏	sux
aclag7	|LU₂×TUG₂|	𒈐	sux
azalag7	|LU₂×TUG₂|	𒈐	sux
azlag7	|LU₂×TUG₂|	𒈐	sux
dubal7	|LU₂×TUG₂|	𒈐	sux
adamen	|LU₂%LU₂|	𒈒	sux
adamin	|LU₂@LU₂|	𒈓	sux
enbir	|LU₂@LU₂|	𒈓	sux
gigam	|LU₂@LU₂|	𒈓	sux
inbir	|LU₂@LU₂|	𒈓	sux
pagrax	|LU₂@LU₂|	𒈓	sux
urbigu3	|LU₂@LU₂|	𒈓	sux
urbingu3	|LU₂@LU₂|	𒈓	sux
addax	|LU₂@g.UŠ₂|	𒍗	sux
/ad/	LU₂@s	𒈕	sux
adx	LU₂@s	𒈕	sux
dimx	LU₂@s	𒈕	sux
ri9	LU₂@s	𒈕	sux
rin5	LU₂@s	𒈕	sux
ug8	LU₂@s	𒈕	sux
lil8	LU₂@t	𒈑	sux
arinax	|LU₂@s.NA|	𒈕𒈾	sux
LAK790	LU₃	𒈖	sux
gadx	LU₃	𒈖	sux
gar5	LU₃	𒈖	sux
gudx	LU₃	𒈖	sux
gug2	LU₃	𒈖	sux
kuk2	LU₃	𒈖	sux
lu3	LU₃	𒈖	sux
titab2	|LU₃.PAP.PAP|	𒁈𒉽𒉽	sux
bara2-munu5~b	|BARA₂.PAP.ŠE.PAP|	𒁈𒉽𒊺𒉽	sux
titab~b	|BARA₂.PAP.ŠE.PAP|	𒁈𒉽𒊺𒉽	sux
LAK165	LUGAL	𒈗	sux
nūr-ili	LUGAL	𒈗	sux
carru	LUGAL	𒈗	sux
biceba	LUGAL	𒈗	sux
bicebi	LUGAL	𒈗	sux
hanic2	LUGAL	𒈗	sux
kacceba	LUGAL	𒈗	sux
kaccebi	LUGAL	𒈗	sux
lillan	LUGAL	𒈗	sux
lugal	LUGAL	𒈗	sux
lugala	LUGAL	𒈗	sux
nurra	LUGAL	𒈗	sux
rab3	LUGAL	𒈗	sux
sag4	LUGAL	𒈗	sux
saj4	LUGAL	𒈗	sux
car3	LUGAL	𒈗	sux
carax	LUGAL	𒈗	sux
carra	LUGAL	𒈗	sux
carru	LUGAL	𒈗	sux
carrum	LUGAL	𒈗	sux
cugur	LUGAL	𒈗	sux
dimx	|LUGAL.GAM|	𒈗𒃵	sux
dim9	|LUGAL.GAN|	𒈗𒃶	sux
dim11	|LUGAL.HI×BAD|	𒈗𒄰	sux
adamen2	|LUGAL&LUGAL|	𒈘	sux
adamin2	|LUGAL&LUGAL|	𒈘	sux
dadrum	|LUGAL&LUGAL|	𒈘	sux
gug5	|LUGAL&LUGAL|	𒈘	sux
kukux	|LUGAL&LUGAL|	𒈘	sux
adamenx	|LUGAL@LUGAL|	𒈙	sux
ex	|LUGAL@LUGAL|	𒈙	sux
gug5	|LUGAL@LUGAL|	𒈙	sux
LAK166	LUGAL@s	𒈚	sux
dim3	LUGAL@s	𒈚	sux
LAK168	LUH	𒈛	sux
huluh	LUH	𒈛	sux
lah3	LUH	𒈛	sux
laha3	LUH	𒈛	sux
lih3	LUH	𒈛	sux
luh	LUH	𒈛	sux
luhu	LUH	𒈛	sux
nah	LUH	𒈛	sux
rah	LUH	𒈛	sux
rih	LUH	𒈛	sux
ruh	LUH	𒈛	sux
subur2	LUH	𒈛	sux
sugal7	LUH	𒈛	sux
sukal	LUH	𒈛	sux
sukkal	LUH	𒈛	sux
cukal	LUH	𒈛	sux
cukkal	LUH	𒈛	sux
LAK242	LUL	𒈜	sux
LAK243	LUL	𒈜	sux
LAK244	LUL	𒈜	sux
MZL570	LUL	𒈜	sux
bah3	LUL	𒈜	sux
buh	LUL	𒈜	sux
dunga2	LUL	𒈜	sux
dugax	LUL	𒈜	sux
ilumer3	LUL	𒈜	sux
ka5	LUL	𒈜	sux
kucum2	LUL	𒈜	sux
lab2	LUL	𒈜	sux
leb	LUL	𒈜	sux
lep	LUL	𒈜	sux
lib	LUL	𒈜	sux
libi	LUL	𒈜	sux
lip	LUL	𒈜	sux
lu5	LUL	𒈜	sux
lub	LUL	𒈜	sux
lugx	LUL	𒈜	sux
lul	LUL	𒈜	sux
lulu	LUL	𒈜	sux
lup	LUL	𒈜	sux
nar	LUL	𒈜	sux
nari	LUL	𒈜	sux
pah	LUL	𒈜	sux
pan2	LUL	𒈜	sux
pih	LUL	𒈜	sux
puh	LUL	𒈜	sux
sar7	LUL	𒈜	sux
sulug	LUL	𒈜	sux
catam	LUL	𒈜	sux
cattam	LUL	𒈜	sux
catam	LUL	𒈜	sux
ce11	LUL	𒈜	sux
zulug	LUL	𒈜	sux
ka10	|LUL.A|	𒈜𒀀	sux
tegi2	|LUL.BALAG|	𒈜𒁆	sux
tigi2	|LUL.BALAG|	𒈜𒁆	sux
tigu2	|LUL.BALAG|	𒈜𒁆	sux
LAK194	LUM	𒈝	sux
eger5	LUM	𒈝	sux
egir5	LUM	𒈝	sux
ejir5	LUM	𒈝	sux
gamx	LUM	𒈝	sux
gu15	LUM	𒈝	sux
gud6	LUM	𒈝	sux
gum2	LUM	𒈝	sux
gumu	LUM	𒈝	sux
gun5	LUM	𒈝	sux
guz	LUM	𒈝	sux
hu5	LUM	𒈝	sux
hum	LUM	𒈝	sux
humu	LUM	𒈝	sux
hus	LUM	𒈝	sux
huz	LUM	𒈝	sux
kunx	LUM	𒈝	sux
kujx	LUM	𒈝	sux
kus2	LUM	𒈝	sux
kus,2	LUM	𒈝	sux
lamx	LUM	𒈝	sux
lu4	LUM	𒈝	sux
lum	LUM	𒈝	sux
luma	LUM	𒈝	sux
lumu	LUM	𒈝	sux
nim4	LUM	𒈝	sux
nu4	LUM	𒈝	sux
num2	LUM	𒈝	sux
qum3	LUM	𒈝	sux
gugumu	|LUM.LUM|	𒈝𒈝	sux
luhum	|LUM.LUM|	𒈝𒈝	sux
gum2-gum2	|LUM&LUM|	𒈞	sux
gumgum	|LUM&LUM|	𒈞	sux
gum2-gum2-kac4	|LUM&LUM.DU@s|	𒈞𒁽	sux
lugud3	|LUM&LUM.GAR&GAR|	𒈟	sux
guhcu2	|LUM&LUM.ŠU₂|	𒈞𒋙	sux
gum2-gum2-cu2	|LUM&LUM.ŠU₂|	𒈞𒋙	sux
gumgumcu	|LUM&LUM.ŠU₂|	𒈞𒋙	sux
LAK34	MA	𒈠	sux
ma	MA	𒈠	sux
pec3	MA	𒈠	sux
pecce	MA	𒈠	sux
wa6	MA	𒈠	sux
cirx	|MA@g×TAK₄|	𒈡	sux
LAK35	MA@g	𒈢	sux
durba	MA@g	𒈢	sux
hachur	MA@g	𒈢	sux
LAK529	MA₂	𒈣	sux
hux	MA₂	𒈣	sux
ma2	MA₂	𒈣	sux
dellux	|MA₂.KAK|	𒈣𒆕	sux
dilurx	|MA₂.KAK|	𒈣𒆕	sux
dirgulx	|MA₂.KAK|	𒈣𒆕	sux
targulx	|MA₂.KAK|	𒈣𒆕	sux
dellu	|MA₂.MUG|	𒈣𒈮	sux
dergul	|MA₂.MUG|	𒈣𒈮	sux
dilu	|MA₂.MUG|	𒈣𒈮	sux
dilur	|MA₂.MUG|	𒈣𒈮	sux
dimgul	|MA₂.MUG|	𒈣𒈮	sux
dirgul	|MA₂.MUG|	𒈣𒈮	sux
durgul	|MA₂.MUG|	𒈣𒈮	sux
targul	|MA₂.MUG|	𒈣𒈮	sux
sur10	|MA₂.IGI@g|	𒈣𒅊	sux
sura10	|MA₂.IGI@g|	𒈣𒅊	sux
surru2	|MA₂.IGI@g|	𒈣𒅊	sux
zur3	|MA₂.IGI@g|	𒈣𒅊	sux
LAK57	MAH	𒈤	sux
MZL91	MAH	𒈤	sux
al6	MAH	𒈤	sux
mah	MAH	𒈤	sux
maha	MAH	𒈤	sux
meh	MAH	𒈤	sux
mih	MAH	𒈤	sux
cutur	MAH	𒈤	sux
LAK126	MAR	𒈥	sux
gar7	MAR	𒈥	sux
jar7	MAR	𒈥	sux
mar	MAR	𒈥	sux
mara	MAR	𒈥	sux
war2	MAR	𒈥	sux
amurrum	|MAR.TU|	𒈥𒌅	sux
LAK42	MAŠ	𒈦	sux
MZL120	MAŠ	𒈦	sux
ba7	MAŠ	𒈦	sux
bac	MAŠ	𒈦	sux
ma7	MAŠ	𒈦	sux
mas	MAŠ	𒈦	sux
maś	MAŠ	𒈦	sux
mac	MAŠ	𒈦	sux
maca	MAŠ	𒈦	sux
mas,	MAŠ	𒈦	sux
nac	MAŠ	𒈦	sux
sa9	MAŠ	𒈦	sux
til9	MAŠ	𒈦	sux
wac	MAŠ	𒈦	sux
zipah	MAŠ	𒈦	sux
1/2(dic)	MAŠ	𒈦	sux
1/2(dic@c)	MAŠ	𒈦	sux
macda2	|MAŠ.EN.KAK|	𒈦𒂗𒆕	sux
KWU104	|MAŠ.GU₂.GAR₃|	𒈦𒄘𒃼	sux
KWU105	|MAŠ.GU₂.GAR₃|	𒈦𒄘𒃼	sux
aBZL30	|MAŠ.GU₂.GAR₃|	𒈦𒄘𒃼	sux
LAK63b	|MAŠ.GU₂.GAR₃|	𒈦𒄘𒃼	sux
dal2	|MAŠ.GU₂.GAR₃|	𒈦𒄘𒃼	sux
dalla	|MAŠ.GU₂.GAR₃|	𒈦𒄘𒃼	sux
macda	|MAŠ.KAK|	𒈦𒆕	sux
macda3	|MAŠ.KAK.EN|	𒈦𒆕𒂗	sux
macmin	|MAŠ.MIN|	𒈦𒈫	sux
sagmin	|MAŠ.MIN|	𒈦𒈫	sux
sajmin	|MAŠ.MIN|	𒈦𒈫	sux
mac3	|MAŠ.PA|	𒈦𒉺	sux
MZL125	|MAŠ.U|	𒈦𒌋	sux
gidim2	|MAŠ.U|	𒈦𒌋	sux
giguru2	|MAŠ.U|	𒈦𒌋	sux
MZL126	|MAŠ.U.U|	𒈦𒌋𒌋	sux
sajgidim	|MAŠ.U.U|	𒈦𒌋𒌋	sux
macmin	|MAŠ.U.U|	𒈦𒌋𒌋	sux
sagman	|MAŠ.U.U|	𒈦𒌋𒌋	sux
sagmin	|MAŠ.U.U|	𒈦𒌋𒌋	sux
sajman	|MAŠ.U.U|	𒈦𒌋𒌋	sux
sajmin	|MAŠ.U.U|	𒈦𒌋𒌋	sux
emac	|MAŠ.X|	𒈦░░	sux
erix	|MAŠ.X|	𒈦░░	sux
LAK43	MAŠ₂	𒈧	sux
MZL130	MAŠ₂	𒈧	sux
kun8	MAŠ₂	𒈧	sux
mac2	MAŠ₂	𒈧	sux
macaku	MAŠ₂	𒈧	sux
maz0	MAŠ₂	𒈧	sux
maz2	MAŠ₂	𒈧	sux
LAK750	ME	𒈨	sux
ba13	ME	𒈨	sux
dec4	ME	𒈨	sux
dic4	ME	𒈨	sux
gax	ME	𒈨	sux
galx	ME	𒈨	sux
gex	ME	𒈨	sux
isib	ME	𒈨	sux
icib	ME	𒈨	sux
ma6	ME	𒈨	sux
me	ME	𒈨	sux
men2	ME	𒈨	sux
mec2	ME	𒈨	sux
mi3	ME	𒈨	sux
sep	ME	𒈨	sux
sib	ME	𒈨	sux
sip	ME	𒈨	sux
cab4	ME	𒈨	sux
ceb	ME	𒈨	sux
cep	ME	𒈨	sux
cib	ME	𒈨	sux
cip	ME	𒈨	sux
tuba	ME	𒈨	sux
kurku	|ME.AN.ŠE.NAGA|	𒈨𒀭𒊺𒉀	sux
gacamx	|ME.NUN.TAG|	𒈨𒉣𒋳	sux
ec17	|ME.U.U.U|	𒈨𒌍	sux
mes3	|ME.U.U.U|	𒈨𒌍	sux
mec	|ME.U.U.U|	𒈨𒌍	sux
mic2	|ME.U.U.U|	𒈨𒌍	sux
wic	|ME.U.U.U|	𒈨𒌍	sux
dubx	MES	𒈩	sux
kicib	MES	𒈩	sux
mes	MES	𒈩	sux
mesa	MES	𒈩	sux
mesi	MES	𒈩	sux
mec3	MES	𒈩	sux
mez	MES	𒈩	sux
mis	MES	𒈩	sux
mic	MES	𒈩	sux
mis,	MES	𒈩	sux
red	MES	𒈩	sux
ret	MES	𒈩	sux
rid	MES	𒈩	sux
rit	MES	𒈩	sux
rit	MES	𒈩	sux
rig11	|MES.RU|	𒈩𒊒	sux
LAK391	MI	𒈪	sux
dugud2	MI	𒈪	sux
ga12	MI	𒈪	sux
ge6	MI	𒈪	sux
gi6	MI	𒈪	sux
gig2	MI	𒈪	sux
giggi	MI	𒈪	sux
gigi2	MI	𒈪	sux
gikki	MI	𒈪	sux
je6	MI	𒈪	sux
ji6	MI	𒈪	sux
ku10	MI	𒈪	sux
ku10-ku10	MI	𒈪	sux
kukku5	MI	𒈪	sux
kuku5	MI	𒈪	sux
me2	MI	𒈪	sux
mi	MI	𒈪	sux
muc9	MI	𒈪	sux
muci	MI	𒈪	sux
mucu	MI	𒈪	sux
sil4	MI	𒈪	sux
sux	MI	𒈪	sux
s,il2	MI	𒈪	sux
wi4	MI	𒈪	sux
kukku2	|MI.MI|	𒈪𒈪	sux
kukkug2	|MI.MI|	𒈪𒈪	sux
cutumx	|MI.NA.AB.U.GUD|	𒈪𒈾𒀊𒌋𒄞	sux
LAK417	MIN	𒈫	sux
menx	MIN	𒈫	sux
min	MIN	𒈫	sux
mina	MIN	𒈫	sux
cin2	MIN	𒈫	sux
cina	MIN	𒈫	sux
2(dic)	MIN	𒈫	sux
2(dic@c)	MIN	𒈫	sux
LAK14	MU	𒈬	sux
MZL98	MU	𒈬	sux
gu10	MU	𒈬	sux
ju10	MU	𒈬	sux
i14	MU	𒈬	sux
ia5	MU	𒈬	sux
mehida	MU	𒈬	sux
mehidi	MU	𒈬	sux
mehidu	MU	𒈬	sux
mu	MU	𒈬	sux
muhaldim	MU	𒈬	sux
muhaldima	MU	𒈬	sux
suh7	MU	𒈬	sux
cad2	MU	𒈬	sux
cu10	MU	𒈬	sux
cum3	MU	𒈬	sux
cumu	MU	𒈬	sux
tah3	MU	𒈬	sux
tuh3	MU	𒈬	sux
wu4	MU	𒈬	sux
mudra6	|MU.BU|	𒈬𒁍	sux
mudru6	|MU.BU|	𒈬𒁍	sux
munzerx	|MU.BU|	𒈬𒁍	sux
cumati	|MU.ME.U.U.U|	𒈬𒈨𒌋𒌋𒌋	sux
cuwati	|MU.ME.U.U.U|	𒈬𒈨𒌋𒌋𒌋	sux
muctu2	|MU.UŠ.TUG₂.PI|	𒈬𒍑𒌆𒉿	sux
muctug2	|MU.UŠ.TUG₂.PI|	𒈬𒍑𒌆𒉿	sux
LAK15	|MU&MU|	𒈭	sux
dah	|MU&MU|	𒈭	sux
tah	|MU&MU|	𒈭	sux
taha	|MU&MU|	𒈭	sux
tuh2	|MU&MU|	𒈭	sux
tah	|MU&MU|	𒈭	sux
MZL12	MUG	𒈮	sux
LAK48	MUG	𒈮	sux
buk	MUG	𒈮	sux
gagim	MUG	𒈮	sux
gaggim	MUG	𒈮	sux
gakim	MUG	𒈮	sux
gugim	MUG	𒈮	sux
gukim	MUG	𒈮	sux
guggim	MUG	𒈮	sux
mug	MUG	𒈮	sux
muga	MUG	𒈮	sux
mugux	MUG	𒈮	sux
muk	MUG	𒈮	sux
muq	MUG	𒈮	sux
puk	MUG	𒈮	sux
cuk2	MUG	𒈮	sux
uttu4	MUG	𒈮	sux
wuk	MUG	𒈮	sux
MZL13	MUG@g	𒈯	sux
uttu4	MUG@g	𒈯	sux
utu4	MUG@g	𒈯	sux
zadim	MUG@g	𒈯	sux
LAK672b	MUNSUB	𒈰	sux
munsub	MUNSUB	𒈰	sux
muncub	MUNSUB	𒈰	sux
musub	MUNSUB	𒈰	sux
sub5	MUNSUB	𒈰	sux
sumur3	MUNSUB	𒈰	sux
cub4	MUNSUB	𒈰	sux
eger6	MURGU₂	𒈱	sux
egir6	MURGU₂	𒈱	sux
ejir6	MURGU₂	𒈱	sux
lumx	MURGU₂	𒈱	sux
mur7	MURGU₂	𒈱	sux
mur8	MURGU₂	𒈱	sux
murgu2	MURGU₂	𒈱	sux
LAK157	MURUB₄	𒉠	sux
mur2	MURUB₄	𒉠	sux
muri	MURUB₄	𒉠	sux
muru2	MURUB₄	𒉠	sux
murub4	MURUB₄	𒉠	sux
LAK235	MUŠ	𒈲	sux
MZL585	MUŠ	𒈲	sux
imdudu	MUŠ	𒈲	sux
irhan	MUŠ	𒈲	sux
mus	MUŠ	𒈲	sux
muc	MUŠ	𒈲	sux
muz	MUŠ	𒈲	sux
nerah	MUŠ	𒈲	sux
nirah	MUŠ	𒈲	sux
sahan	MUŠ	𒈲	sux
cahan2	MUŠ	𒈲	sux
cer10	MUŠ	𒈲	sux
cerah	MUŠ	𒈲	sux
cir10	MUŠ	𒈲	sux
cubax	MUŠ	𒈲	sux
s,er	MUŠ	𒈲	sux
s,ir	MUŠ	𒈲	sux
s,ur2	MUŠ	𒈲	sux
wuc	MUŠ	𒈲	sux
uludi	MUŠ	𒈲	sux
uluki	MUŠ	𒈲	sux
zer3	MUŠ	𒈲	sux
zir3	MUŠ	𒈲	sux
cubax	|MUŠ.ŠA|	𒈲𒊭	sux
cex	|MUŠ×A|	𒈳	sux
cex	|MUŠ×ZA|	𒈵	sux
LAK236	|MUŠ%MUŠ|	𒈸	sux
kunigara4	|MUŠ%MUŠ|	𒈸	sux
mucx	|MUŠ%MUŠ|	𒈸	sux
mucdama2	|MUŠ%MUŠ|	𒈸	sux
muckux	|MUŠ%MUŠ|	𒈸	sux
re8	|MUŠ%MUŠ|	𒈸	sux
ri8	|MUŠ%MUŠ|	𒈸	sux
rin4	|MUŠ%MUŠ|	𒈸	sux
arina	|MUŠ%MUŠ.A.NA|	𒈸𒀀𒈾	sux
erina8	|MUŠ%MUŠ.A.NA|	𒈸𒀀𒈾	sux
irina	|MUŠ%MUŠ.A.NA|	𒈸𒀀𒈾	sux
arinax	|MUŠ&MUŠ.A.NA|	𒈶𒀀𒈾	sux
arinax	|MUŠ&MUŠ×(A.NA)|	𒈷	sux
LAK462	MUŠ₃	𒈹	sux
ennin	MUŠ₃	𒈹	sux
ga-ca-an-an-na	MUŠ₃	𒈹	sux
inana	MUŠ₃	𒈹	sux
inanna	MUŠ₃	𒈹	sux
inini	MUŠ₃	𒈹	sux
innana	MUŠ₃	𒈹	sux
innin	MUŠ₃	𒈹	sux
ictar	MUŠ₃	𒈹	sux
mim2	MUŠ₃	𒈹	sux
muc3	MUŠ₃	𒈹	sux
mucku	MUŠ₃	𒈹	sux
nin2	MUŠ₃	𒈹	sux
ninni6	MUŠ₃	𒈹	sux
sar5	MUŠ₃	𒈹	sux
se27	MUŠ₃	𒈹	sux
sed6	MUŠ₃	𒈹	sux
sedi6	MUŠ₃	𒈹	sux
suba4	MUŠ₃	𒈹	sux
suh10	MUŠ₃	𒈹	sux
suku6	MUŠ₃	𒈹	sux
sukud3	MUŠ₃	𒈹	sux
sukuc	MUŠ₃	𒈹	sux
sus2	MUŠ₃	𒈹	sux
susbu4	MUŠ₃	𒈹	sux
suz2	MUŠ₃	𒈹	sux
ce23	MUŠ₃	𒈹	sux
ced12	MUŠ₃	𒈹	sux
cuba4	MUŠ₃	𒈹	sux
zanaru	MUŠ₃	𒈹	sux
zannaru	MUŠ₃	𒈹	sux
sugal5	|MUŠ₃.AB|	𒈹𒀊	sux
zabala5	|MUŠ₃.AB|	𒈹𒀊	sux
zabalam5	|MUŠ₃.AB|	𒈹𒀊	sux
sugal3	|MUŠ₃.AB@g|	𒈹𒀕	sux
zabala3	|MUŠ₃.AB@g|	𒈹𒀕	sux
zabalam3	|MUŠ₃.AB@g|	𒈹𒀕	sux
zabalax	|MUŠ₃.AB@g.ZA|	𒈹𒀕𒍝	sux
susbu3	|MUŠ₃.BU|	𒈹𒁍	sux
suzbu3	|MUŠ₃.BU|	𒈹𒁍	sux
amagix	|MUŠ₃.DI|	𒈹𒁲	sux
halbax	|MUŠ₃.DI|	𒈹𒁲	sux
halbix	|MUŠ₃.DI|	𒈹𒁲	sux
mabix	|MUŠ₃.DI|	𒈹𒁲	sux
mammix	|MUŠ₃.DI|	𒈹𒁲	sux
se25	|MUŠ₃.DI|	𒈹𒁲	sux
sed4	|MUŠ₃.DI|	𒈹𒁲	sux
sedi4	|MUŠ₃.DI|	𒈹𒁲	sux
ce17	|MUŠ₃.DI|	𒈹𒁲	sux
ced10	|MUŠ₃.DI|	𒈹𒁲	sux
se24~a	|A.MUŠ₃|	𒀀𒈹	sux
sed3~a	|A.MUŠ₃|	𒀀𒈹	sux
sedi3~a	|A.MUŠ₃|	𒀀𒈹	sux
ce12~a	|A.MUŠ₃|	𒀀𒈹	sux
ced9~a	|A.MUŠ₃|	𒀀𒈹	sux
amagi2~b	|A.MUŠ₃.DI|	𒀀𒈹𒁲	sux
halba6~b	|A.MUŠ₃.DI|	𒀀𒈹𒁲	sux
halbi6~b	|A.MUŠ₃.DI|	𒀀𒈹𒁲	sux
halbu6~b	|A.MUŠ₃.DI|	𒀀𒈹𒁲	sux
mabi2~b	|A.MUŠ₃.DI|	𒀀𒈹𒁲	sux
mammi2~b	|A.MUŠ₃.DI|	𒀀𒈹𒁲	sux
se26~b	|A.MUŠ₃.DI|	𒀀𒈹𒁲	sux
sed5~b	|A.MUŠ₃.DI|	𒀀𒈹𒁲	sux
sedi5~b	|A.MUŠ₃.DI|	𒀀𒈹𒁲	sux
ce18~b	|A.MUŠ₃.DI|	𒀀𒈹𒁲	sux
ced11~b	|A.MUŠ₃.DI|	𒀀𒈹𒁲	sux
amagix~c	|A.MUŠ₃×A.DI|	𒀀𒈺𒁲	sux
halbax~c	|A.MUŠ₃×A.DI|	𒀀𒈺𒁲	sux
halbix~c	|A.MUŠ₃×A.DI|	𒀀𒈺𒁲	sux
mabix~c	|A.MUŠ₃×A.DI|	𒀀𒈺𒁲	sux
mammix~c	|A.MUŠ₃×A.DI|	𒀀𒈺𒁲	sux
cex~c	|A.MUŠ₃×A.DI|	𒀀𒈺𒁲	sux
amagix~d	|A.MUŠ₃.A.DI|	𒀀𒈹𒀀𒁲	sux
cex~e	|MUŠ₃×A|	𒈺	sux
cedx~e	|MUŠ₃×A|	𒈺	sux
amagi~f	|MUŠ₃×(A.DI)|	𒈻	sux
halba~f	|MUŠ₃×(A.DI)|	𒈻	sux
halbi~f	|MUŠ₃×(A.DI)|	𒈻	sux
halbu~f	|MUŠ₃×(A.DI)|	𒈻	sux
mabi~f	|MUŠ₃×(A.DI)|	𒈻	sux
mammi~f	|MUŠ₃×(A.DI)|	𒈻	sux
se9~f	|MUŠ₃×(A.DI)|	𒈻	sux
sed~f	|MUŠ₃×(A.DI)|	𒈻	sux
sedi~f	|MUŠ₃×(A.DI)|	𒈻	sux
sid~f	|MUŠ₃×(A.DI)|	𒈻	sux
ce4~f	|MUŠ₃×(A.DI)|	𒈻	sux
ced7~f	|MUŠ₃×(A.DI)|	𒈻	sux
amagix~g	|MUŠ₃×DI|	𒈼	sux
halbax~g	|MUŠ₃×DI|	𒈼	sux
halbix~g	|MUŠ₃×DI|	𒈼	sux
sex~g	|MUŠ₃×DI|	𒈼	sux
sedx~g	|MUŠ₃×DI|	𒈼	sux
cex~g	|MUŠ₃×DI|	𒈼	sux
amagi3~h	|ZA.MUŠ₃.DI|	𒍝𒈹𒁲	sux
halba2~h	|ZA.MUŠ₃.DI|	𒍝𒈹𒁲	sux
halbi2~h	|ZA.MUŠ₃.DI|	𒍝𒈹𒁲	sux
halbu2~h	|ZA.MUŠ₃.DI|	𒍝𒈹𒁲	sux
mabi3~h	|ZA.MUŠ₃.DI|	𒍝𒈹𒁲	sux
mammi3~h	|ZA.MUŠ₃.DI|	𒍝𒈹𒁲	sux
se10~h	|ZA.MUŠ₃.DI|	𒍝𒈹𒁲	sux
sed8~h	|ZA.MUŠ₃.DI|	𒍝𒈹𒁲	sux
sedi8~h	|ZA.MUŠ₃.DI|	𒍝𒈹𒁲	sux
ce5~h	|ZA.MUŠ₃.DI|	𒍝𒈹𒁲	sux
ced8~h	|ZA.MUŠ₃.DI|	𒍝𒈹𒁲	sux
namru~i	|ZA.MUŠ₃@g.DI|	𒍝𒈽𒁲	sux
amagi4~i	|ZA.MUŠ₃@g.DI|	𒍝𒈽𒁲	sux
halba3~i	|ZA.MUŠ₃@g.DI|	𒍝𒈽𒁲	sux
halbi3~i	|ZA.MUŠ₃@g.DI|	𒍝𒈽𒁲	sux
halbu3~i	|ZA.MUŠ₃@g.DI|	𒍝𒈽𒁲	sux
incucinak	|MUŠ₃.EREN|	𒈹𒂞	sux
susan	|MUŠ₃.EREN|	𒈹𒂞	sux
cucin	|MUŠ₃.EREN|	𒈹𒂞	sux
cucina	|MUŠ₃.EREN|	𒈹𒂞	sux
cucinak	|MUŠ₃.EREN|	𒈹𒂞	sux
cucum	|MUŠ₃.EREN|	𒈹𒂞	sux
nam-ri	|MUŠ₃.ZA|	𒈹𒍝	sux
subx	|MUŠ₃.ZA|	𒈹𒍝	sux
suba3	|MUŠ₃.ZA|	𒈹𒍝	sux
cuba3	|MUŠ₃.ZA|	𒈹𒍝	sux
sugal4	|MUŠ₃.ZA.AB@g|	𒈹𒍝𒀕	sux
zabala4	|MUŠ₃.ZA.AB@g|	𒈹𒍝𒀕	sux
zabalam4	|MUŠ₃.ZA.AB@g|	𒈹𒍝𒀕	sux
LAK463	MUŠ₃@g	𒈽	sux
muc2	MUŠ₃@g	𒈽	sux
se28	MUŠ₃@g	𒈽	sux
sed7	MUŠ₃@g	𒈽	sux
sedi7	MUŠ₃@g	𒈽	sux
sih4	MUŠ₃@g	𒈽	sux
su10	MUŠ₃@g	𒈽	sux
suh	MUŠ₃@g	𒈽	sux
suku5	MUŠ₃@g	𒈽	sux
sukud2	MUŠ₃@g	𒈽	sux
sus	MUŠ₃@g	𒈽	sux
susbu2	MUŠ₃@g	𒈽	sux
sucbu	MUŠ₃@g	𒈽	sux
suz	MUŠ₃@g	𒈽	sux
suzbu2	MUŠ₃@g	𒈽	sux
ce24	MUŠ₃@g	𒈽	sux
ced13	MUŠ₃@g	𒈽	sux
cuh	MUŠ₃@g	𒈽	sux
cukx	MUŠ₃@g	𒈽	sux
cusbu	MUŠ₃@g	𒈽	sux
cucinakx	MUŠ₃@g	𒈽	sux
ticpak	MUŠ₃@g	𒈽	sux
susbu	|MUŠ₃@g.BU|	𒈽𒁍	sux
suzbu	|MUŠ₃@g.BU|	𒈽𒁍	sux
cucux	|MUŠ₃@g.SIK₂.LAM|	𒈽𒋠𒇴	sux
MZL110	NA	𒈾	sux
LAK22	NA	𒈾	sux
aniku	NA	𒈾	sux
na	NA	𒈾	sux
ne6	NA	𒈾	sux
nu8	NA	𒈾	sux
hurim	|NA.RU|	𒈾𒊒	sux
hurin	|NA.RU|	𒈾𒊒	sux
LAK221	NA₂	𒈿	sux
daramx	NA₂	𒈿	sux
na2	NA₂	𒈿	sux
nad3	NA₂	𒈿	sux
ne7	NA₂	𒈿	sux
nu2	NA₂	𒈿	sux
nud	NA₂	𒈿	sux
cex	NA₂	𒈿	sux
timuax	NA₂	𒈿	sux
ni-ir	|NA₂.X|	𒈿░░	sux
LAK209	NAGA	𒉀	sux
MZL	NAGA	𒉀	sux
erec2	NAGA	𒉀	sux
eric2	NAGA	𒉀	sux
hilib2	NAGA	𒉀	sux
naga	NAGA	𒉀	sux
naja	NAGA	𒉀	sux
nak2	NAGA	𒉀	sux
nama	NAGA	𒉀	sux
nanga6	NAGA	𒉀	sux
nidaba2	NAGA	𒉀	sux
nisaba2	NAGA	𒉀	sux
te3	NAGA	𒉀	sux
teme	NAGA	𒉀	sux
tu22	NAGA	𒉀	sux
ugax	NAGA	𒉀	sux
MZL	NAGA@180	𒉁	sux
teme2	NAGA@180	𒉁	sux
MZL	|NAGA×ŠU@t|	𒉂	sux
tu23	|NAGA×ŠU@t|	𒉂	sux
dalhamun7	|NAGA@NAGA|	𒉃	sux
hamun	|NAGA@NAGA|	𒉃	sux
LAK512	NAGAR	𒉄	sux
alla	NAGAR	𒉄	sux
bulug4	NAGAR	𒉄	sux
e10	NAGAR	𒉄	sux
haia	NAGAR	𒉄	sux
haya	NAGAR	𒉄	sux
ildumx	NAGAR	𒉄	sux
illa	NAGAR	𒉄	sux
lamga	NAGAR	𒉄	sux
nagar	NAGAR	𒉄	sux
nagara	NAGAR	𒉄	sux
niminx	NAGAR	𒉄	sux
ildu3	|NAGAR.BU|	𒉄𒁍	sux
ildum3	|NAGAR.BU|	𒉄𒁍	sux
ilduma3	|NAGAR.BU|	𒉄𒁍	sux
ildumma3	|NAGAR.BU|	𒉄𒁍	sux
tugul	|NAGAR.ZA@t|	𒉄𒍞	sux
tuhul	|NAGAR.ZA@t|	𒉄𒍞	sux
LAK71	NAM	𒉆	sux
MZL134	NAM	𒉆	sux
bix	NAM	𒉆	sux
bir5	NAM	𒉆	sux
na7	NAM	𒉆	sux
nam	NAM	𒉆	sux
pir6	NAM	𒉆	sux
si13	NAM	𒉆	sux
sim	NAM	𒉆	sux
sin2	NAM	𒉆	sux
śim2	NAM	𒉆	sux
cam4	NAM	𒉆	sux
cen3	NAM	𒉆	sux
cim2	NAM	𒉆	sux
pala2	|NAM.EN|	𒉆𒂗	sux
pala	|NAM.LUGAL|	𒉆𒈗	sux
pala3	|NAM.SAL.TUG₂|	𒉆𒊩𒌆	sux
rug2	|NAM.SU|	𒉆𒋢	sux
LAK792	NAM₂	𒉇	sux
nam2	NAM₂	𒉇	sux
LAK148	NE	𒉈	sux
bar7	NE	𒉈	sux
barax	NE	𒉈	sux
be7	NE	𒉈	sux
bel	NE	𒉈	sux
bi2	NE	𒉈	sux
bil	NE	𒉈	sux
bila	NE	𒉈	sux
bili	NE	𒉈	sux
bir9	NE	𒉈	sux
de3	NE	𒉈	sux
di7	NE	𒉈	sux
didalx	NE	𒉈	sux
du17	NE	𒉈	sux
ge9	NE	𒉈	sux
gi9	NE	𒉈	sux
gibil4	NE	𒉈	sux
gir10	NE	𒉈	sux
gum3	NE	𒉈	sux
ibbix	NE	𒉈	sux
izi	NE	𒉈	sux
izu	NE	𒉈	sux
ku16	NE	𒉈	sux
kum2	NE	𒉈	sux
kun9	NE	𒉈	sux
lam2	NE	𒉈	sux
lama2	NE	𒉈	sux
le9	NE	𒉈	sux
lem4	NE	𒉈	sux
li9	NE	𒉈	sux
lim4	NE	𒉈	sux
ne	NE	𒉈	sux
ni5	NE	𒉈	sux
nunx	NE	𒉈	sux
pe5	NE	𒉈	sux
pel	NE	𒉈	sux
pi5	NE	𒉈	sux
pil	NE	𒉈	sux
qum2	NE	𒉈	sux
carx	NE	𒉈	sux
ce6	NE	𒉈	sux
ceg6	NE	𒉈	sux
cej6	NE	𒉈	sux
cemx	NE	𒉈	sux
s,ah	NE	𒉈	sux
s,eh2	NE	𒉈	sux
te4	NE	𒉈	sux
ti9	NE	𒉈	sux
te3	NE	𒉈	sux
ti5	NE	𒉈	sux
zah	NE	𒉈	sux
zix	NE	𒉈	sux
enx	|NE.GI|	𒉈𒄀	sux
gibil6	|NE.GI|	𒉈𒄀	sux
gir18	|NE.GI|	𒉈𒄀	sux
gira3	|NE.GI|	𒉈𒄀	sux
girra	|NE.GI|	𒉈𒄀	sux
erim2	|NE.RU|	𒉈𒊒	sux
erima2	|NE.RU|	𒉈𒊒	sux
erin7	|NE.RU|	𒉈𒊒	sux
ne-ru	|NE.RU|	𒉈𒊒	sux
/nerim/	|NE.RU|	𒉈𒊒	sux
rim3	|NE.RU|	𒉈𒊒	sux
rum2	|NE.RU|	𒉈𒊒	sux
dubx	|NE.SI.A|	𒉈𒋛𒀀	sux
ganzer2	|NE.SI.A|	𒉈𒋛𒀀	sux
ganzir2	|NE.SI.A|	𒉈𒋛𒀀	sux
udub3	|NE.SI.A|	𒉈𒋛𒀀	sux
lisi	|NE.SI@g|	𒉈𒋜	sux
lisin	|NE.SI@g|	𒉈𒋜	sux
enten	|NE×A|	𒉉	sux
entena	|NE×A|	𒉉	sux
ec13	|NE×A|	𒉉	sux
emec2	|NE×UD|	𒉊	sux
ec12	|NE×UD|	𒉊	sux
MZL312	NE@s	𒉋	sux
bel2	NE@s	𒉋	sux
bi5	NE@s	𒉋	sux
bil2	NE@s	𒉋	sux
ge10	NE@s	𒉋	sux
gi10	NE@s	𒉋	sux
gibil	NE@s	𒉋	sux
gibila	NE@s	𒉋	sux
ne8	NE@s	𒉋	sux
pel2	NE@s	𒉋	sux
pil2	NE@s	𒉋	sux
LAK506	NI	𒉌	sux
MZL380	NI	𒉌	sux
camnu	NI	𒉌	sux
)a5	NI	𒉌	sux
be3	NI	𒉌	sux
bu16	NI	𒉌	sux
dex	NI	𒉌	sux
dig	NI	𒉌	sux
digi	NI	𒉌	sux
dik	NI	𒉌	sux
diq	NI	𒉌	sux
gamar	NI	𒉌	sux
gub4	NI	𒉌	sux
gur13	NI	𒉌	sux
hax	NI	𒉌	sux
i3	NI	𒉌	sux
ia3	NI	𒉌	sux
ilix	NI	𒉌	sux
le2	NI	𒉌	sux
li2	NI	𒉌	sux
libx	NI	𒉌	sux
lid2	NI	𒉌	sux
mu5	NI	𒉌	sux
ne2	NI	𒉌	sux
ni	NI	𒉌	sux
sal3	NI	𒉌	sux
sar3	NI	𒉌	sux
sul2	NI	𒉌	sux
suc2	NI	𒉌	sux
cal3	NI	𒉌	sux
car8	NI	𒉌	sux
s,al	NI	𒉌	sux
tik2	NI	𒉌	sux
tiq2	NI	𒉌	sux
ux	NI	𒉌	sux
ya3	NI	𒉌	sux
zagga	NI	𒉌	sux
zaja	NI	𒉌	sux
zal	NI	𒉌	sux
zala	NI	𒉌	sux
zalli	NI	𒉌	sux
zanga	NI	𒉌	sux
zar2	NI	𒉌	sux
LAK513	|NI.GIŠ|	𒉌𒄑	sux
par4	|NI.GIŠ|	𒉌𒄑	sux
para4	|NI.GIŠ|	𒉌𒄑	sux
ilī	|NI.NI|	𒉌𒉌	sux
libx	|NI.LU|	𒉌𒇻	sux
LAK514	|NI.TUK|	𒉌𒌇	sux
delmun	|NI.TUK|	𒉌𒌇	sux
dilmun	|NI.TUK|	𒉌𒌇	sux
dilmuna	|NI.TUK|	𒉌𒌇	sux
telmun	|NI.TUK|	𒉌𒌇	sux
tilmun	|NI.TUK|	𒉌𒌇	sux
LAK511	|NI.UD|	𒉌𒌓	sux
abnu	|NI.UD|	𒉌𒌓	sux
atumx	|NI.UD|	𒉌𒌓	sux
bar4	|NI.UD|	𒉌𒌓	sux
dag3	|NI.UD|	𒉌𒌓	sux
dak3	|NI.UD|	𒉌𒌓	sux
daq3	|NI.UD|	𒉌𒌓	sux
i4	|NI.UD|	𒉌𒌓	sux
ia4	|NI.UD|	𒉌𒌓	sux
na4	|NI.UD|	𒉌𒌓	sux
tak3	|NI.UD|	𒉌𒌓	sux
taq3	|NI.UD|	𒉌𒌓	sux
ya4	|NI.UD|	𒉌𒌓	sux
za2	|NI.UD|	𒉌𒌓	sux
enna	|NI.UD.EN|	𒉌𒌓𒂗	sux
enaqa	|NI.UD.IM|	𒉌𒌓𒅎	sux
atum	|NI.UD.KI|	𒉌𒌓𒆠	sux
LAK377	NI₂	𒉎	sux
ni2	NI₂	𒉎	sux
me10	NI₂	𒉎	sux
nigidaec	NIGIDAEŠ	𒑗	sux
niec	NIGIDAEŠ	𒑗	sux
3(barig)	NIGIDAEŠ	𒑗	sux
3(barig@c)	NIGIDAEŠ	𒑗	sux
3(bariga)	NIGIDAEŠ	𒑗	sux
3(bariga@c)	NIGIDAEŠ	𒑗	sux
LAK271	NIM	𒉏	sux
alamax	NIM	𒉏	sux
deh3	NIM	𒉏	sux
dehi3	NIM	𒉏	sux
dih3	NIM	𒉏	sux
dihi3	NIM	𒉏	sux
elam	NIM	𒉏	sux
elama	NIM	𒉏	sux
elamu	NIM	𒉏	sux
enim2	NIM	𒉏	sux
nam3	NIM	𒉏	sux
nem	NIM	𒉏	sux
ni7	NIM	𒉏	sux
nim	NIM	𒉏	sux
nima	NIM	𒉏	sux
nu3	NIM	𒉏	sux
num	NIM	𒉏	sux
rum3	NIM	𒉏	sux
tehe3	NIM	𒉏	sux
tehi3	NIM	𒉏	sux
tu8	NIM	𒉏	sux
tum4	NIM	𒉏	sux
tumu4	NIM	𒉏	sux
LAK272	|NIM×GAN₂@t|	𒉐	sux
kux	|NIM×GAN₂@t|	𒉐	sux
tu25	|NIM×GAN₂@t|	𒉐	sux
tum3	|NIM×GAN₂@t|	𒉐	sux
tumu3	|NIM×GAN₂@t|	𒉐	sux
kir7	|NIM×(GAR.GAN₂@t)|	𒉑	sux
tum11	|NIM×(GAR.GAN₂@t)|	𒉑	sux
nigidamin	NIGIDAMIN	𒑖	sux
2(barig)	NIGIDAMIN	𒑖	sux
2(barig@c)	NIGIDAMIN	𒑖	sux
2(bariga)	NIGIDAMIN	𒑖	sux
2(bariga@c)	NIGIDAMIN	𒑖	sux
nimin3	NIGIDAMIN	𒑖	sux
LAK95	NINDA₂	𒉒	sux
gur9	NINDA₂	𒉒	sux
inda	NINDA₂	𒉒	sux
nida2	NINDA₂	𒉒	sux
ninda2	NINDA₂	𒉒	sux
sax	|NINDA₂×AN|	𒉓	sux
samx	|NINDA₂×AN|	𒉓	sux
san3	|NINDA₂×AN|	𒉓	sux
cam3	|NINDA₂×AN|	𒉓	sux
can	|NINDA₂×AN|	𒉓	sux
indagarax	|NINDA₂×AŠ|	𒉔	sux
sax	|NINDA₂×(AŠ.AŠ)|	𒉕	sux
LAK104	|NINDA₂×GUD|	𒉖	sux
indagara	|NINDA₂×GUD|	𒉖	sux
indagra	|NINDA₂×GUD|	𒉖	sux
nindamekar	|NINDA₂×(ME.GAN₂@t)|	𒉗	sux
LAK109	|NINDA₂×NE|	𒉘	sux
ag2	|NINDA₂×NE|	𒉘	sux
aga2	|NINDA₂×NE|	𒉘	sux
aj2	|NINDA₂×NE|	𒉘	sux
aka2	|NINDA₂×NE|	𒉘	sux
am2	|NINDA₂×NE|	𒉘	sux
eg3	|NINDA₂×NE|	𒉘	sux
ej3	|NINDA₂×NE|	𒉘	sux
em3	|NINDA₂×NE|	𒉘	sux
ig3	|NINDA₂×NE|	𒉘	sux
ij3	|NINDA₂×NE|	𒉘	sux
im3	|NINDA₂×NE|	𒉘	sux
ram	|NINDA₂×NE|	𒉘	sux
rama	|NINDA₂×NE|	𒉘	sux
ugx	|NINDA₂×NE|	𒉘	sux
LAK108	|NINDA₂×ŠE|	𒉚	sux
agx	|NINDA₂×ŠE|	𒉚	sux
sa10	|NINDA₂×ŠE|	𒉚	sux
sam2	|NINDA₂×ŠE|	𒉚	sux
cam2	|NINDA₂×ŠE|	𒉚	sux
sax	|NINDA₂×ŠE.A|	𒉚𒀀	sux
samx	|NINDA₂×ŠE.A|	𒉚𒀀	sux
camx	|NINDA₂×ŠE.A|	𒉚𒀀	sux
sax	|NINDA₂×ŠE.A.AN|	𒉚𒀀𒀭	sux
samx	|NINDA₂×ŠE.A.AN|	𒉚𒀀𒀭	sux
camx	|NINDA₂×ŠE.A.AN|	𒉚𒀀𒀭	sux
sax	|NINDA₂×(ŠE.A).AN|	𒉛	sux
samx	|NINDA₂×(ŠE.A).AN|	𒉛	sux
camx	|NINDA₂×(ŠE.A).AN|	𒉛	sux
sax	|NINDA₂×(ŠE.AŠ)|	𒉜	sux
sax	|NINDA₂×(ŠE.AŠ.AŠ)|	𒉝	sux
muru11	|NINDA₂×(U₂.AŠ)|	𒉞	sux
murum11	|NINDA₂×(U₂.AŠ)|	𒉞	sux
ubudil	|NINDA₂×(U₂.AŠ)|	𒉞	sux
ubudili	|NINDA₂×(U₂.AŠ)|	𒉞	sux
ugudil	|NINDA₂×(U₂.AŠ)|	𒉞	sux
ugudili	|NINDA₂×(U₂.AŠ)|	𒉞	sux
ur7	|NINDA₂×(U₂.AŠ)|	𒉞	sux
uru6	|NINDA₂×(U₂.AŠ)|	𒉞	sux
urum	|NINDA₂×(U₂.AŠ)|	𒉞	sux
ucbar6	|NINDA₂×(U₂.AŠ)|	𒉞	sux
ucbur6	|NINDA₂×(U₂.AŠ)|	𒉞	sux
suhuc2	|NINDA₂×UŠ|	𒉟	sux
LAK159	NISAG	𒉠	sux
nesag	NISAG	𒉠	sux
nesaj	NISAG	𒉠	sux
nisag	NISAG	𒉠	sux
nisaj	NISAG	𒉠	sux
sax	NISAG	𒉠	sux
sag5	NISAG	𒉠	sux
saj5	NISAG	𒉠	sux
zax	NISAG	𒉠	sux
zag3	NISAG	𒉠	sux
zaj3	NISAG	𒉠	sux
MZL112	NU	𒉡	sux
LAK36	NU	𒉡	sux
la3	NU	𒉡	sux
nu	NU	𒉡	sux
sarx	NU	𒉡	sux
sir5	NU	𒉡	sux
surx	NU	𒉡	sux
cir5	NU	𒉡	sux
ul2	NU	𒉡	sux
LAK24	NU₁₁	𒉢	sux
MZL115b	NU₁₁	𒉢	sux
duri	NU₁₁	𒉢	sux
encab	NU₁₁	𒉢	sux
jecnux	NU₁₁	𒉢	sux
gecnu	NU₁₁	𒉢	sux
gicnu	NU₁₁	𒉢	sux
nu11	NU₁₁	𒉢	sux
numx	NU₁₁	𒉢	sux
nurx	NU₁₁	𒉢	sux
pil6	NU₁₁	𒉢	sux
sakarx	NU₁₁	𒉢	sux
sudx	NU₁₁	𒉢	sux
bur4	|NU₁₁.BUR|	𒉢𒁓	sux
buru4	|NU₁₁.BUR|	𒉢𒁓	sux
gasx	|NU₁₁.BUR|	𒉢𒁓	sux
ugax	|NU₁₁.BUR|	𒉢𒁓	sux
lagas	|NU₁₁.BUR.LA|	𒉢𒁓𒆷	sux
lagasa	|NU₁₁.BUR.LA|	𒉢𒁓𒆷	sux
lagac	|NU₁₁.BUR.LA|	𒉢𒁓𒆷	sux
lagaca	|NU₁₁.BUR.LA|	𒉢𒁓𒆷	sux
jecnu	|NU₁₁.GIŠ|	𒉢𒄑	sux
jicnu	|NU₁₁.GIŠ|	𒉢𒄑	sux
buru15	|NU₁₁.IR|	𒉢𒅕	sux
gecnu2	|NU₁₁.IR|	𒉢𒅕	sux
jecnu2	|NU₁₁.IR|	𒉢𒅕	sux
gicnu2	|NU₁₁.IR|	𒉢𒅕	sux
jicnu2	|NU₁₁.IR|	𒉢𒅕	sux
sirru	|NU₁₁.IR|	𒉢𒅕	sux
numma	|NU₁₁&NU₁₁.BUR&BUR|	𒋕	sux
LAK76	NUN	𒉣	sux
MZL143	NUN	𒉣	sux
abx	NUN	𒉣	sux
agargarax	NUN	𒉣	sux
dabx	NUN	𒉣	sux
dabax	NUN	𒉣	sux
erida	NUN	𒉣	sux
eridu	NUN	𒉣	sux
eridug	NUN	𒉣	sux
eriduga	NUN	𒉣	sux
gar6	NUN	𒉣	sux
gara6	NUN	𒉣	sux
li11	NUN	𒉣	sux
nu6	NUN	𒉣	sux
nujx	NUN	𒉣	sux
nun	NUN	𒉣	sux
nuna	NUN	𒉣	sux
nunun	NUN	𒉣	sux
rabx	NUN	𒉣	sux
...ri	NUN	𒉣	sux
sil2	NUN	𒉣	sux
s,il	NUN	𒉣	sux
za4	NUN	𒉣	sux
zalx	NUN	𒉣	sux
zel	NUN	𒉣	sux
zil	NUN	𒉣	sux
LAK78	|NUN.LAGAR|	𒉣𒇬	sux
MZL145	|NUN.LAGAR|	𒉣𒇬	sux
immalx	|NUN.LAGAR|	𒉣𒇬	sux
malx	|NUN.LAGAR|	𒉣𒇬	sux
surum	|NUN.LAGAR|	𒉣𒇬	sux
cilamx	|NUN.LAGAR|	𒉣𒇬	sux
curumx	|NUN.LAGAR|	𒉣𒇬	sux
tur3	|NUN.LAGAR|	𒉣𒇬	sux
MZL146''	|NUN.LAGAR×GAR|	𒉤	sux
gagax	|NUN.LAGAR×GAR|	𒉤	sux
galgax	|NUN.LAGAR×GAR|	𒉤	sux
jalgax	|NUN.LAGAR×GAR|	𒉤	sux
MZL147	|NUN.LAGAR×SAL|	𒉦	sux
arhus2	|NUN.LAGAR×SAL|	𒉦	sux
arhuc2	|NUN.LAGAR×SAL|	𒉦	sux
immal2	|NUN.LAGAR×SAL|	𒉦	sux
callam	|NUN.LAGAR×SAL|	𒉦	sux
cilax	|NUN.LAGAR×SAL|	𒉦	sux
cilam	|NUN.LAGAR×SAL|	𒉦	sux
uc5	|NUN.LAGAR×SAL|	𒉦	sux
MZL146'	|NUN.LAGAR×UŠ|	𒉨	sux
...rig	|NUN.LAGAR×UŠ|	𒉨	sux
abgal	|NUN.ME|	𒉣𒈨	sux
RSP95~a	|NUN.ME.KA×GAN₂@t|	𒉣𒈨𒅤	sux
abgal2~a	|NUN.ME.KA×GAN₂@t|	𒉣𒈨𒅤	sux
RSP95~b	|NUN.ME.KA×ME|	𒉣𒈨𒅴	sux
abgalx~b	|NUN.ME.KA×ME|	𒉣𒈨𒅴	sux
abrig	|NUN.ME.DU|	𒉣𒈨𒁺	sux
abrig2~a	|AB₂.NUN.ME.DU|	𒀖𒉣𒈨𒁺	sux
{+ab2}abrig~a	|AB₂.NUN.ME.DU|	𒀖𒉣𒈨𒁺	sux
gacam	|NUN.ME.TAG|	𒉣𒈨𒋳	sux
gaccu	|NUN.ME.TAG|	𒉣𒈨𒋳	sux
kici12	|NUN.ŠE|	𒉣𒊺	sux
zi...	|NUN.ŠE|	𒉣𒊺	sux
LAK122	|NUN&NUN|	𒉪	sux
MZL502	|NUN&NUN|	𒉪	sux
nar3	|NUN&NUN|	𒉪	sux
narax	|NUN&NUN|	𒉪	sux
nenerx	|NUN&NUN|	𒉪	sux
ner	|NUN&NUN|	𒉪	sux
ninir	|NUN&NUN|	𒉪	sux
nir	|NUN&NUN|	𒉪	sux
nira	|NUN&NUN|	𒉪	sux
nur	|NUN&NUN|	𒉪	sux
ri5	|NUN&NUN|	𒉪	sux
cer7	|NUN&NUN|	𒉪	sux
tirx	|NUN&NUN|	𒉪	sux
akarx	|(NUN.LAGAR×SAL)&(NUN.LAGAR×SAL)|	𒉧	sux
MZL107	|NUN%NUN|	𒉫	sux
adamen4	|NUN%NUN|	𒉫	sux
adamin4	|NUN%NUN|	𒉫	sux
eribura	|NUN%NUN|	𒉫	sux
iribura	|NUN%NUN|	𒉫	sux
liri6	|NUN%NUN|	𒉫	sux
liru6	|NUN%NUN|	𒉫	sux
lirum6	|NUN%NUN|	𒉫	sux
ced3	|NUN%NUN|	𒉫	sux
cecced	|NUN%NUN|	𒉫	sux
cid3	|NUN%NUN|	𒉫	sux
urgilim	|NUN%NUN|	𒉫	sux
akar	|NUN%NUN.LAGAR&LAGAR|	𒉬	sux
ega2	|NUN%NUN.LAGAR&LAGAR|	𒉬	sux
MZL144	NUN@t	𒉩	sux
agargara	NUN@t	𒉩	sux
nappilu	NUN@t	𒉩	sux
garx	NUN@t	𒉩	sux
gur19	|NUN@t.KI|	𒉩𒆠	sux
guru19	|NUN@t.KI|	𒉩𒆠	sux
gurud	|NUN@t.KI|	𒉩𒆠	sux
kur11	|NUN@t.KI|	𒉩𒆠	sux
kuru11	|NUN@t.KI|	𒉩𒆠	sux
kurud	|NUN@t.KI|	𒉩𒆠	sux
kuruda	|NUN@t.KI|	𒉩𒆠	sux
nunpe	|NUN@t.KI|	𒉩𒆠	sux
zilpe	|NUN@t.KI|	𒉩𒆠	sux
guruda~a	|NUN.KI|	𒉣𒆠	sux
nunpex~a	|NUN.KI|	𒉣𒆠	sux
zi...	|NUN@t.ŠE|	𒉩𒊺	sux
LAK813	NUNUZ	𒉭	sux
nunu	NUNUZ	𒉭	sux
nunus	NUNUZ	𒉭	sux
nunuz	NUNUZ	𒉭	sux
nus	NUNUZ	𒉭	sux
nuz	NUNUZ	𒉭	sux
pel5	NUNUZ	𒉭	sux
sug9	NUNUZ	𒉭	sux
LAK449	|NUNUZ.AB₂|	𒉭𒀖	sux
nisagga	|NUNUZ.AB₂|	𒉭𒀖	sux
LAK451	|NUNUZ.AB₂×AŠGAB|	𒉮	sux
saman5	|NUNUZ.AB₂×AŠGAB|	𒉮	sux
cakan5	|NUNUZ.AB₂×AŠGAB|	𒉮	sux
usan3	|NUNUZ.AB₂×AŠGAB|	𒉮	sux
usan3-sur5	|NUNUZ.AB₂×AŠGAB|	𒉮	sux
usandux	|NUNUZ.AB₂×AŠGAB|	𒉮	sux
usansurux	|NUNUZ.AB₂×AŠGAB|	𒉮	sux
usun	|NUNUZ.AB₂×AŠGAB|	𒉮	sux
uzunx	|NUNUZ.AB₂×AŠGAB|	𒉮	sux
harax	|NUNUZ.AB₂×BI|	𒉯	sux
hubur	|NUNUZ.AB₂×BI|	𒉯	sux
mud3	|NUNUZ.AB₂×BI|	𒉯	sux
pihu2	|NUNUZ.AB₂×BI|	𒉯	sux
lahtan5	|NUNUZ.AB₂×DUG|	𒉰	sux
usagx	|NUNUZ.AB₂×GUD|	𒉱	sux
usanx	|NUNUZ.AB₂×GUD|	𒉱	sux
mud8	|NUNUZ.AB₂×KAD₃|	𒉳	sux
lahtax	|NUNUZ.AB₂×LA|	𒉴	sux
lahtan	|NUNUZ.AB₂×LA|	𒉴	sux
mudx	|NUNUZ.AB₂×LA|	𒉴	sux
usagx	|NUNUZ.AB₂×LA|	𒉴	sux
lahtan4	|NUNUZ.AB₂×NE|	𒉵	sux
pihu6	|NUNUZ.AB₂×IGI@g|	𒉲	sux
lahtan2	|NUNUZ.AB₂×SILA₃|	𒉶	sux
harubx	|NUNUZ.AB₂×U₂|	𒉷	sux
[...]di	|NUNUZ.AB₂×X|	𒉭	sux
[...]gida	|NUNUZ.AB₂×X|	𒉭	sux
huburx	|NUNUZ.AB₂×X|	𒉭	sux
mudx	|NUNUZ.AB₂×X|	𒉭	sux
nigi3	|NUNUZ.DIM₂|	𒉭𒁶	sux
nisaga	|NUNUZ.KISIM₅|	𒉭𒆨	sux
harax	|NUNUZ.KISIM₅×BI|	𒉸	sux
lahtan3	|NUNUZ.KISIM₅×BI.U|	𒉹	sux
o	O	0	sux
LAK121	PA	𒉺	sux
addirx	PA	𒉺	sux
ari3	PA	𒉺	sux
aru	PA	𒉺	sux
ba2	PA	𒉺	sux
dur6	PA	𒉺	sux
duru6	PA	𒉺	sux
endur	PA	𒉺	sux
gectara	PA	𒉺	sux
gidar	PA	𒉺	sux
gidirx	PA	𒉺	sux
gidri	PA	𒉺	sux
gidru	PA	𒉺	sux
gicturu	PA	𒉺	sux
jedar	PA	𒉺	sux
jedru	PA	𒉺	sux
jecturu	PA	𒉺	sux
jidri	PA	𒉺	sux
jidru	PA	𒉺	sux
had	PA	𒉺	sux
hanic3	PA	𒉺	sux
has2	PA	𒉺	sux
has,2	PA	𒉺	sux
hat	PA	𒉺	sux
hata	PA	𒉺	sux
hat	PA	𒉺	sux
haz2	PA	𒉺	sux
hendur	PA	𒉺	sux
hud	PA	𒉺	sux
kumx	PA	𒉺	sux
kun2	PA	𒉺	sux
lar	PA	𒉺	sux
lu9	PA	𒉺	sux
lug2	PA	𒉺	sux
luj2	PA	𒉺	sux
lun	PA	𒉺	sux
mac4	PA	𒉺	sux
midra	PA	𒉺	sux
mu6	PA	𒉺	sux
mua	PA	𒉺	sux
muati	PA	𒉺	sux
muatu	PA	𒉺	sux
mudru	PA	𒉺	sux
munsubx	PA	𒉺	sux
muwa	PA	𒉺	sux
muwati	PA	𒉺	sux
muya	PA	𒉺	sux
muyati	PA	𒉺	sux
pa	PA	𒉺	sux
sag3	PA	𒉺	sux
sak3	PA	𒉺	sux
seg3	PA	𒉺	sux
si29	PA	𒉺	sux
sig3	PA	𒉺	sux
sigga2	PA	𒉺	sux
siqqax	PA	𒉺	sux
sullat2	PA	𒉺	sux
cag3	PA	𒉺	sux
cullat2	PA	𒉺	sux
ux	PA	𒉺	sux
ugula	PA	𒉺	sux
ugulu	PA	𒉺	sux
zag2	PA	𒉺	sux
zak2	PA	𒉺	sux
zaq2	PA	𒉺	sux
cabra	|PA.AL|	𒉺𒀠	sux
capra	|PA.AL|	𒉺𒀠	sux
billuda	|PA.AN|	𒉺𒀭	sux
billudu	|PA.AN|	𒉺𒀭	sux
biluda	|PA.AN|	𒉺𒀭	sux
garza	|PA.AN|	𒉺𒀭	sux
garzu	|PA.AN|	𒉺𒀭	sux
jarza	|PA.AN|	𒉺𒀭	sux
jarzu	|PA.AN|	𒉺𒀭	sux
kuc4	|PA.AN|	𒉺𒀭	sux
udul11	|PA.DAG.KISIM₅×GUD|	𒉺𒁖	sux
utul11	|PA.DAG.KISIM₅×GUD|	𒉺𒁖	sux
gabar	|PA.DAG.KISIM₅×KAK|	𒉺𒁖	sux
kabar	|PA.DAG.KISIM₅×KAK|	𒉺𒁖	sux
kapar	|PA.DAG.KISIM₅×KAK|	𒉺𒁖	sux
nagada	|PA.DAG.KISIM₅×KAK|	𒉺𒁖	sux
rig10	|PA.DAG.KISIM₅×KAK|	𒉺𒁖	sux
ririg	|PA.DAG.KISIM₅×KAK|	𒉺𒁖	sux
udul9	|PA.DAG.KISIM₅×KAK|	𒉺𒁖	sux
utul9	|PA.DAG.KISIM₅×KAK|	𒉺𒁖	sux
mackim3	|PA.DU|	𒉺𒁺	sux
mackim2	|PA.DU@g|	𒉺𒁼	sux
barim	|PA.DU@s|	𒉺𒁽	sux
mackim	|PA.DU@s|	𒉺𒁽	sux
parim	|PA.DU@s|	𒉺𒁽	sux
hursag	|PA.DUN₃|	𒉺𒂅	sux
hursaj	|PA.DUN₃|	𒉺𒂅	sux
cabra2	|PA.E₂|	𒉺𒂍	sux
capra2	|PA.E₂|	𒉺𒂍	sux
luga	|PA.GA₂|	𒉺𒂷	sux
luja	|PA.GA₂|	𒉺𒂷	sux
sag2	|PA.GAN|	𒉺𒃶	sux
seg11	|PA.GAN|	𒉺𒃶	sux
sig11	|PA.GAN|	𒉺𒃶	sux
sikix	|PA.GAN|	𒉺𒃶	sux
zigx	|PA.GI|	𒉺𒄀	sux
munsubx	|PA.GU₂@g|	𒉺𒄝	sux
rig8	|PA.HUB₂|	𒉺𒄸	sux
rig7	|PA.HUB₂.DU|	𒉺𒄸𒁺	sux
LAK129?	|PA.IB|	𒉺𒅁	sux
hamanzer	|PA.IB|	𒉺𒅁	sux
sab	|PA.IB|	𒉺𒅁	sux
sap	|PA.IB|	𒉺𒅁	sux
sip4	|PA.IB|	𒉺𒅁	sux
sipa2	|PA.IB|	𒉺𒅁	sux
cab	|PA.IB|	𒉺𒅁	sux
caba	|PA.IB|	𒉺𒅁	sux
cap	|PA.IB|	𒉺𒅁	sux
cib3	|PA.IB|	𒉺𒅁	sux
cip3	|PA.IB|	𒉺𒅁	sux
cub3	|PA.IB|	𒉺𒅁	sux
cup3	|PA.IB|	𒉺𒅁	sux
hutpu	|PA.KAK|	𒉺𒆕	sux
hudbu	|PA.KAK|	𒉺𒆕	sux
re)u	|PA.LU|	𒉺𒇻	sux
nuska2	|PA.LU|	𒉺𒇻	sux
nusku2	|PA.LU|	𒉺𒇻	sux
nucka2	|PA.LU|	𒉺𒇻	sux
nucku2	|PA.LU|	𒉺𒇻	sux
re)e	|PA.LU|	𒉺𒇻	sux
re)i	|PA.LU|	𒉺𒇻	sux
sap3	|PA.LU|	𒉺𒇻	sux
sib2	|PA.LU|	𒉺𒇻	sux
siba	|PA.LU|	𒉺𒇻	sux
sibad	|PA.LU|	𒉺𒇻	sux
sip2	|PA.LU|	𒉺𒇻	sux
sipa	|PA.LU|	𒉺𒇻	sux
sipad	|PA.LU|	𒉺𒇻	sux
cab5	|PA.LU|	𒉺𒇻	sux
cap5	|PA.LU|	𒉺𒇻	sux
zip3	|PA.LU|	𒉺𒇻	sux
garza2	|PA.LUGAL|	𒉺𒈗	sux
girza	|PA.LUGAL|	𒉺𒈗	sux
jarza2	|PA.LUGAL|	𒉺𒈗	sux
ari5	|PA.ME.U.U.U|	𒉺𒈨𒌋𒌋𒌋	sux
udulx	|PA.NUN.LAGAR|	𒉺𒉣𒇬	sux
tertu	|PA.SU|	𒉺𒋢	sux
erida2	|PA.ŠA₆|	𒉺𒊷	sux
erimx	|PA.ŠA₆|	𒉺𒊷	sux
gangud	|PA.ŠA₆|	𒉺𒊷	sux
canga7	|PA.ŠA₆|	𒉺𒊷	sux
tidimx	|PA.ŠA₆|	𒉺𒊷	sux
isin	|PA.ŠE|	𒉺𒊺	sux
icin	|PA.ŠE|	𒉺𒊺	sux
en5	|PA.TE|	𒉺𒋼	sux
ninx	|PA.TE|	𒉺𒋼	sux
ensag	|PA.TE.SI|	𒉺𒋼𒋛	sux
ensi2	|PA.TE.SI|	𒉺𒋼𒋛	sux
ensik	|PA.TE.SI|	𒉺𒋼𒋛	sux
ensix	|PA.TE.SI.GAR|	𒉺𒋼𒋛𒃻	sux
encada	|PA.TUG₂|	𒉺𒌆	sux
encadu	|PA.TUG₂|	𒉺𒌆	sux
nuska	|PA.TUG₂|	𒉺𒌆	sux
nucka	|PA.TUG₂|	𒉺𒌆	sux
nusku	|PA.TUG₂|	𒉺𒌆	sux
rigx	|PA.TUK.DU|	𒉺𒌇𒁺	sux
sugx	|PA.SUD.EL|	𒉺𒋤𒂖	sux
sulilix	|PA.URU×MIN|	𒉺𒍇	sux
zililix	|PA.URU×MIN|	𒉺𒍇	sux
zilulu	|PA.URU×MIN|	𒉺𒍇	sux
dud	|PA.UZU|	𒉺𒍜	sux
duda	|PA.UZU|	𒉺𒍜	sux
dudux	|PA.UZU|	𒉺𒍜	sux
dunda	|PA.UZU|	𒉺𒍜	sux
tud2	|PA.UZU|	𒉺𒍜	sux
tudu	|PA.UZU|	𒉺𒍜	sux
tunda	|PA.UZU|	𒉺𒍜	sux
LAK398	PAD	𒉻	sux
bad2	PAD	𒉻	sux
bat2	PAD	𒉻	sux
bu15	PAD	𒉻	sux
kur6	PAD	𒉻	sux
kurum6	PAD	𒉻	sux
kurummax	PAD	𒉻	sux
pax	PAD	𒉻	sux
pad	PAD	𒉻	sux
pada	PAD	𒉻	sux
pat	PAD	𒉻	sux
pata	PAD	𒉻	sux
pat	PAD	𒉻	sux
cug	PAD	𒉻	sux
cuk	PAD	𒉻	sux
cuku	PAD	𒉻	sux
cukun3	PAD	𒉻	sux
cukur2	PAD	𒉻	sux
cuq	PAD	𒉻	sux
cutug	PAD	𒉻	sux
nindabax	|PAD.AN.MUŠ₂|	𒉻𒀭𒈽	sux
nidba	|PAD.AN.MUŠ₃|	𒉻𒀭𒈹	sux
nindaba	|PAD.AN.MUŠ₃|	𒉻𒀭𒈹	sux
ninni7	|PAD.AN.MUŠ₃|	𒉻𒀭𒈹	sux
ninnim7	|PAD.AN.MUŠ₃|	𒉻𒀭𒈹	sux
nidba2	|PAD.MUŠ₃|	𒉻𒈹	sux
nindabax	|PAD.MUŠ₃|	𒉻𒈹	sux
ninnix	|PAD.MUŠ₃|	𒉻𒈹	sux
ninnimx	|PAD.MUŠ₃|	𒉻𒈹	sux
LAK38	PAN	𒉼	sux
ba10	PAN	𒉼	sux
ban	PAN	𒉼	sux
bana	PAN	𒉼	sux
pan	PAN	𒉼	sux
pana	PAN	𒉼	sux
tir5	PAN	𒉼	sux
LAK229	PAP	𒉽	sux
MZL92	PAP	𒉽	sux
aha3	PAP	𒉽	sux
ba14	PAP	𒉽	sux
bab	PAP	𒉽	sux
bap	PAP	𒉽	sux
gur12	PAP	𒉽	sux
kur2	PAP	𒉽	sux
kuru2	PAP	𒉽	sux
pa4	PAP	𒉽	sux
pab	PAP	𒉽	sux
pap	PAP	𒉽	sux
qur4	PAP	𒉽	sux
MZL96	|PAP.E|	𒉽𒂊	sux
pa5	|PAP.E|	𒉽𒂊	sux
pad5	|PAP.E|	𒉽𒂊	sux
MZL93	|PAP.HAL|	𒉽𒄬	sux
puc2	|PAP.HAL|	𒉽𒄬	sux
MZL95	|PAP.IŠ|	𒉽𒅖	sux
pa6	|PAP.IŠ|	𒉽𒅖	sux
pad6	|PAP.IŠ|	𒉽𒅖	sux
LAK230	|PAP.PAP|	𒉽𒉽	sux
MZL94	|PAP.PAP|	𒉽𒉽	sux
aman	|PAP.PAP|	𒉽𒉽	sux
bu10	|PAP.PAP|	𒉽𒉽	sux
bulug3	|PAP.PAP|	𒉽𒉽	sux
buluj3	|PAP.PAP|	𒉽𒉽	sux
bulunx	|PAP.PAP|	𒉽𒉽	sux
bur13	|PAP.PAP|	𒉽𒉽	sux
dim4	|PAP.PAP|	𒉽𒉽	sux
munu4	|PAP.PAP|	𒉽𒉽	sux
pur13	|PAP.PAP|	𒉽𒉽	sux
munux	|PAP.PAP×ŠE|	𒉽	sux
cucru	|PAP.PAP.4×IDIM|	𒉽𒉽░░	sux
cuccub	|PAP.PAP.4×IDIM|	𒉽𒉽░░	sux
isima	|PAP.IGI@g|	𒉽𒅊	sux
isimu	|PAP.IGI@g|	𒉽𒅊	sux
isimud	|PAP.IGI@g|	𒉽𒅊	sux
pap-ugur2	|PAP.IGI@g|	𒉽𒅊	sux
isimu4	|PAP.IGI@g.NUN.ME|	𒉽𒅊𒉣𒈨	sux
isimud4	|PAP.IGI@g.NUN.ME|	𒉽𒅊𒉣𒈨	sux
munu5	|PAP.ŠE.PAP|	𒉽𒊺𒉽	sux
ge19	PEŠ₂	𒉾	sux
gilili	PEŠ₂	𒉾	sux
gilim2	PEŠ₂	𒉾	sux
gilin	PEŠ₂	𒉾	sux
ka6	PEŠ₂	𒉾	sux
kilim	PEŠ₂	𒉾	sux
kilin	PEŠ₂	𒉾	sux
kic5	PEŠ₂	𒉾	sux
kici5	PEŠ₂	𒉾	sux
kicib2	PEŠ₂	𒉾	sux
kuc10	PEŠ₂	𒉾	sux
nika	PEŠ₂	𒉾	sux
pec2	PEŠ₂	𒉾	sux
pic2	PEŠ₂	𒉾	sux
LAK447	PI	𒉿	sux
a3	PI	𒉿	sux
am7	PI	𒉿	sux
aw	PI	𒉿	sux
bax	PI	𒉿	sux
be6	PI	𒉿	sux
bi3	PI	𒉿	sux
bux	PI	𒉿	sux
dax	PI	𒉿	sux
ex	PI	𒉿	sux
ew	PI	𒉿	sux
geltan	PI	𒉿	sux
gecdu	PI	𒉿	sux
gectu	PI	𒉿	sux
gectug	PI	𒉿	sux
gectunux	PI	𒉿	sux
gicdu	PI	𒉿	sux
gictu	PI	𒉿	sux
gictug	PI	𒉿	sux
gictunux	PI	𒉿	sux
jestug	PI	𒉿	sux
jecdu	PI	𒉿	sux
jectu	PI	𒉿	sux
jectug	PI	𒉿	sux
jistug	PI	𒉿	sux
jicdu	PI	𒉿	sux
jictu	PI	𒉿	sux
jictug	PI	𒉿	sux
i16	PI	𒉿	sux
ia8	PI	𒉿	sux
iu2	PI	𒉿	sux
iw	PI	𒉿	sux
ma9	PI	𒉿	sux
me8	PI	𒉿	sux
mectunux	PI	𒉿	sux
mi5	PI	𒉿	sux
mictunux	PI	𒉿	sux
muctu	PI	𒉿	sux
muctug	PI	𒉿	sux
neda	PI	𒉿	sux
pa12	PI	𒉿	sux
pe	PI	𒉿	sux
pi	PI	𒉿	sux
ta7	PI	𒉿	sux
tal2	PI	𒉿	sux
tala2	PI	𒉿	sux
til7	PI	𒉿	sux
u17	PI	𒉿	sux
uctu	PI	𒉿	sux
uctug	PI	𒉿	sux
uw	PI	𒉿	sux
wa	PI	𒉿	sux
we	PI	𒉿	sux
wi	PI	𒉿	sux
wu	PI	𒉿	sux
ya	PI	𒉿	sux
ye	PI	𒉿	sux
yi	PI	𒉿	sux
yu	PI	𒉿	sux
jectux	|PI.GIŠ.TUG₂|	𒉿𒄑𒌆	sux
wa4	|PI×A|	𒊀	sux
we2	|PI×E|	𒊄	sux
wi2	|PI×I|	𒊅	sux
wu2	|PI×U|	𒊇	sux
wu3	|PI×U₂|	𒊈	sux
taltal	|PI%PI|	𒊉	sux
LAK257	PIRIG	𒊊	sux
ne3	PIRIG	𒊊	sux
nemurx	PIRIG	𒊊	sux
nisku	PIRIG	𒊊	sux
niskum	PIRIG	𒊊	sux
pil7	PIRIG	𒊊	sux
pirig	PIRIG	𒊊	sux
piriga	PIRIG	𒊊	sux
pirij	PIRIG	𒊊	sux
pirija	PIRIG	𒊊	sux
ug2	PIRIG	𒊊	sux
uj2	PIRIG	𒊊	sux
nergal	|PIRIG.AB@g.GAL|	𒊊𒀕𒃲	sux
nerigal	|PIRIG.AB@g.GAL|	𒊊𒀕𒃲	sux
didanu	|PIRIG.PIRIG|	𒊊𒊊	sux
didanum	|PIRIG.PIRIG|	𒊊𒊊	sux
didnu	|PIRIG.PIRIG|	𒊊𒊊	sux
didnum	|PIRIG.PIRIG|	𒊊𒊊	sux
tidanu	|PIRIG.PIRIG|	𒊊𒊊	sux
tidanum	|PIRIG.PIRIG|	𒊊𒊊	sux
tidnim	|PIRIG.PIRIG|	𒊊𒊊	sux
tidnu	|PIRIG.PIRIG|	𒊊𒊊	sux
nemurx	|PIRIG.TUR|	𒊊𒌉	sux
nimurx	|PIRIG.TUR|	𒊊𒌉	sux
nib	|PIRIG×KAL|	𒊋	sux
LAK259	|PIRIG×UD|	𒊌	sux
pirig3	|PIRIG×UD|	𒊌	sux
pirij3	|PIRIG×UD|	𒊌	sux
u21	|PIRIG×UD|	𒊌	sux
udx	|PIRIG×UD|	𒊌	sux
ug	|PIRIG×UD|	𒊌	sux
uk	|PIRIG×UD|	𒊌	sux
uku4	|PIRIG×UD|	𒊌	sux
uq	|PIRIG×UD|	𒊌	sux
LAK261	|PIRIG×ZA|	𒊍	sux
as	|PIRIG×ZA|	𒊍	sux
asa	|PIRIG×ZA|	𒊍	sux
as,	|PIRIG×ZA|	𒊍	sux
az	|PIRIG×ZA|	𒊍	sux
aza	|PIRIG×ZA|	𒊍	sux
ugx	|PIRIG×ZA|	𒊍	sux
us4	|PIRIG×ZA|	𒊍	sux
us,4	|PIRIG×ZA|	𒊍	sux
uz4	|PIRIG×ZA|	𒊍	sux
tidnum	|PIRIG@PIRIG|	𒊎	sux
LAK710	RA	𒊏	sux
ra	RA	𒊏	sux
rah2	RA	𒊏	sux
kutu2	|RA.RA|	𒊏𒊏	sux
rab	RAB	𒊐	sux
raba	RAB	𒊐	sux
rap	RAB	𒊐	sux
gucur2	|RAB.GAL|	𒊐𒃲	sux
jucur2	|RAB.GAL|	𒊐𒃲	sux
ur13	|RAB.GAL|	𒊐𒃲	sux
dim8	|RAB.GAN|	𒊐𒃶	sux
dim10	|RAB.HI×BAD|	𒊐𒄰	sux
jucurx	|RAB.MAH|	𒊐𒈤	sux
jucurx	|RAB.TUR.TUR|	𒊐𒌉𒌉	sux
LAK75	RI	𒊑	sux
bagx	RI	𒊑	sux
bakx	RI	𒊑	sux
dal	RI	𒊑	sux
dala	RI	𒊑	sux
de5	RI	𒊑	sux
degx	RI	𒊑	sux
di5	RI	𒊑	sux
ec11	RI	𒊑	sux
hux	RI	𒊑	sux
re	RI	𒊑	sux
ri	RI	𒊑	sux
rig5	RI	𒊑	sux
ca7	RI	𒊑	sux
tal	RI	𒊑	sux
tala	RI	𒊑	sux
tal	RI	𒊑	sux
MZL111	RU	𒊒	sux
LAK281	RU	𒊒	sux
gecba	RU	𒊒	sux
gecbu	RU	𒊒	sux
gecpa	RU	𒊒	sux
gecpu	RU	𒊒	sux
jecba	RU	𒊒	sux
jecbu	RU	𒊒	sux
jecpa	RU	𒊒	sux
jecpu	RU	𒊒	sux
ilar	RU	𒊒	sux
illar	RU	𒊒	sux
illulu	RU	𒊒	sux
illur	RU	𒊒	sux
illuru	RU	𒊒	sux
ru	RU	𒊒	sux
sub7	RU	𒊒	sux
cib2	RU	𒊒	sux
cux	RU	𒊒	sux
cub	RU	𒊒	sux
cuba5	RU	𒊒	sux
cup	RU	𒊒	sux
rimx	|RU.NE|	𒊒𒉈	sux
LAK731	SA	𒊓	sux
gid3	SA	𒊓	sux
sa	SA	𒊓	sux
śa	SA	𒊓	sux
ca10	SA	𒊓	sux
ellandu	|SA.HI×ŠE.KAK|	𒊓𒄵𒆕	sux
LAK307	SAG	𒊕	sux
rēcu	SAG	𒊕	sux
dul7	SAG	𒊕	sux
dunga	SAG	𒊕	sux
res	SAG	𒊕	sux
rec	SAG	𒊕	sux
ris	SAG	𒊕	sux
ric	SAG	𒊕	sux
sa12	SAG	𒊕	sux
sag	SAG	𒊕	sux
saga	SAG	𒊕	sux
saggar	SAG	𒊕	sux
sajjar	SAG	𒊕	sux
saj	SAG	𒊕	sux
saja	SAG	𒊕	sux
sak	SAG	𒊕	sux
samx	SAG	𒊕	sux
san	SAG	𒊕	sux
saq	SAG	𒊕	sux
sur14	SAG	𒊕	sux
ca24	SAG	𒊕	sux
cag	SAG	𒊕	sux
cak	SAG	𒊕	sux
caq	SAG	𒊕	sux
cegx	SAG	𒊕	sux
zug3	SAG	𒊕	sux
tirigi	|SAG.AN|	𒊕𒀭	sux
casuk	|SAG.DUN₃|	𒊕𒂅	sux
durme	|SAG.EZEN|	𒊕𒂡	sux
zarah	|SAG.PA.LAGAB|	𒊕𒉺𒆸	sux
eru2	|SAG.SAL|	𒊕𒊩	sux
erum2	|SAG.SAL|	𒊕𒊩	sux
kabx	|SAG×A|	𒊖	sux
LAK314	|SAG×DU|	𒊗	sux
muhhu	|SAG×DU|	𒊗	sux
sagdu	|SAG×DU|	𒊗	sux
sajdu	|SAG×DU|	𒊗	sux
uru10	|SAG×DUB|	𒊘	sux
urum3	|SAG×DUB|	𒊘	sux
LAK308	|SAG×HA|	𒊙	sux
hulumx	|SAG×HA|	𒊙	sux
LAK312	|SAG×KAK|	𒊚	sux
muhhu	|SAG×KAK|	𒊚	sux
muh2	|SAG×KAK|	𒊚	sux
xx	|SAG×KAK.GABA|	𒊚𒃮	sux
...gukin	|SAG×KUR|	𒊛	sux
muhhu	|SAG×LUM|	𒊜	sux
hulum2	|SAG×LUM|	𒊜	sux
MZL195	|SAG×MI|	𒊝	sux
kan3	|SAG×MI|	𒊝	sux
kana3	|SAG×MI|	𒊝	sux
MZL56~a	|KA×MI|	𒅸	sux
ganax~a	|KA×MI|	𒅸	sux
kan5~a	|KA×MI|	𒅸	sux
kana5~a	|KA×MI|	𒅸	sux
dilib4	|SAG×NUN|	𒊞	sux
dilib6	|SAG×SAL|	𒊟	sux
eru3	|SAG×SAL|	𒊟	sux
erum3	|SAG×SAL|	𒊟	sux
dilib3	|SAG×ŠID|	𒊠	sux
usag	|SAG×U₂|	𒊢	sux
usug3	|SAG×U₂|	𒊢	sux
uzug3	|SAG×U₂|	𒊢	sux
zug3	|SAG×U₂|	𒊢	sux
muh3	|SAG×UB|	𒊣	sux
lib5	|SAG×UM|	𒊤	sux
gud2	|SAG×UR|	𒊥	sux
guda3	|SAG×UR|	𒊥	sux
gudu2	|SAG×UR|	𒊥	sux
dilib5	|SAG×UŠ|	𒊦	sux
sagminx	|SAG&SAG|	𒊧	sux
sajminx	|SAG&SAG|	𒊧	sux
LAK317	SAG@g	𒊨	sux
muhhu	SAG@g	𒊨	sux
s,almu	SAG@g	𒊨	sux
dilx	SAG@g	𒊨	sux
dul3	SAG@g	𒊨	sux
kuc2	SAG@g	𒊨	sux
kucu4	SAG@g	𒊨	sux
muh4	SAG@g	𒊨	sux
sumur	SAG@g	𒊨	sux
sur2	SAG@g	𒊨	sux
śur2	SAG@g	𒊨	sux
cur2	SAG@g	𒊨	sux
ugu5	SAG@g	𒊨	sux
kec4	SAG@n	𒊔	sux
kece4	SAG@n	𒊔	sux
kici4	SAG@n	𒊔	sux
LAK517	SAL	𒊩	sux
f	SAL	𒊩	sux
gal4	SAL	𒊩	sux
gambix	SAL	𒊩	sux
jal4	SAL	𒊩	sux
kal4	SAL	𒊩	sux
lagarx	SAL	𒊩	sux
mam2	SAL	𒊩	sux
man2	SAL	𒊩	sux
mex	SAL	𒊩	sux
mem	SAL	𒊩	sux
mi2	SAL	𒊩	sux
mim	SAL	𒊩	sux
min2	SAL	𒊩	sux
mu10	SAL	𒊩	sux
mug2	SAL	𒊩	sux
muk0	SAL	𒊩	sux
muk3	SAL	𒊩	sux
munus	SAL	𒊩	sux
munuz	SAL	𒊩	sux
murub	SAL	𒊩	sux
nunusx	SAL	𒊩	sux
rag	SAL	𒊩	sux
rak	SAL	𒊩	sux
raq	SAL	𒊩	sux
sal	SAL	𒊩	sux
sala	SAL	𒊩	sux
ca12	SAL	𒊩	sux
cal	SAL	𒊩	sux
cel4	SAL	𒊩	sux
eme7	|SAL.AL|	𒊩𒀠	sux
sukkal3	|SAL.AL|	𒊩𒀠	sux
eme3	|SAL.ANŠE|	𒊩𒀲	sux
nitadamx	|SAL.ARAD.DAM|	𒊩𒀴𒁮	sux
murubx	|SAL.ARAD.DAM|	𒊩𒀴𒁮	sux
ac2-gar3	|SAL.AŠ₂.GAR₃|	𒊩𒀾𒃼	sux
rak0	|SAL.BAR|	𒊩𒁇	sux
emex	|SAL.EN|	𒊩𒂗	sux
ege2	|SAL.EŠ₂|	𒊩𒂠	sux
eger3	|SAL.EŠ₂|	𒊩𒂠	sux
egi2	|SAL.EŠ₂|	𒊩𒂠	sux
egir3	|SAL.EŠ₂|	𒊩𒂠	sux
ninx	|SAL.EŠ₂|	𒊩𒂠	sux
kir11	|SAL.GA₂×PA|	𒊩𒃢	sux
mirx	|SAL.GA₂×PA|	𒊩𒃢	sux
eme5	|SAL.HUB₂|	𒊩𒄸	sux
emerah	|SAL.HUB₂|	𒊩𒄸	sux
lagar3	|SAL.HUB₂|	𒊩𒄸	sux
sukkal2	|SAL.HUB₂|	𒊩𒄸	sux
e13	|SAL.KU|	𒊩𒆪	sux
nen9	|SAL.KU|	𒊩𒆪	sux
nin9	|SAL.KU|	𒊩𒆪	sux
amat	|SAL.KUR|	𒊩𒆳	sux
amtu	|SAL.KUR|	𒊩𒆳	sux
ge12	|SAL.KUR|	𒊩𒆳	sux
gem3	|SAL.KUR|	𒊩𒆳	sux
geme2	|SAL.KUR|	𒊩𒆳	sux
gi12	|SAL.KUR|	𒊩𒆳	sux
gim3	|SAL.KUR|	𒊩𒆳	sux
gin5	|SAL.KUR|	𒊩𒆳	sux
kucx	|SAL.KUŠU₂|	𒊩𒆵	sux
kucux	|SAL.KUŠU₂|	𒊩𒆵	sux
kuyax	|SAL.KUŠU₂|	𒊩𒆵	sux
gal4-la	|SAL.LA|	𒊩𒆷	sux
gala2	|SAL.LA|	𒊩𒆷	sux
galla2	|SAL.LA|	𒊩𒆷	sux
kala2	|SAL.LA|	𒊩𒆷	sux
emezix	|SAL.LAGAB|	𒊩𒆸	sux
murubx	|SAL.LAGAB|	𒊩𒆸	sux
MZL885	|SAL.LAGAB×AŠ₂|	𒊪	sux
emec	|SAL.LAGAR|	𒊩𒇬	sux
emezi	|SAL.LAGAR|	𒊩𒇬	sux
ezix	|SAL.LAGAR|	𒊩𒇬	sux
garimx	|SAL.LAGAR|	𒊩𒇬	sux
garinx	|SAL.LAGAR|	𒊩𒇬	sux
murub2	|SAL.LAGAR|	𒊩𒇬	sux
umahx	|SAL.LAGAR|	𒊩𒇬	sux
usuh	|SAL.LAGAR|	𒊩𒇬	sux
mam3	|SAL.MA|	𒊩𒈠	sux
mim4	|SAL.MA|	𒊩𒈠	sux
mim-ma	|SAL.MA|	𒊩𒈠	sux
lagar2	|SAL.ME|	𒊩𒈨	sux
lukur	|SAL.ME|	𒊩𒈨	sux
nin10	|SAL.SIK₂|	𒊩𒋠	sux
megidax	|SAL.TAB.KUN|	𒊩𒋰𒆲	sux
kid8	|SAL.TAK₄|	𒊩𒋺	sux
e5	|SAL.TUG₂|	𒊩𒌆	sux
erec	|SAL.TUG₂|	𒊩𒌆	sux
eric	|SAL.TUG₂|	𒊩𒌆	sux
in5	|SAL.TUG₂|	𒊩𒌆	sux
min4	|SAL.TUG₂|	𒊩𒌆	sux
nen	|SAL.TUG₂|	𒊩𒌆	sux
ni4	|SAL.TUG₂|	𒊩𒌆	sux
nim2	|SAL.TUG₂|	𒊩𒌆	sux
nin	|SAL.TUG₂|	𒊩𒌆	sux
nina3	|SAL.TUG₂|	𒊩𒌆	sux
nenkum	|SAL.TUG₂.PAP.IGI@g.NUN.ME.EZEN×KASKAL|	𒊩𒌆𒉽𒅊𒉣𒈨𒂬	sux
ninkum	|SAL.TUG₂.PAP.IGI@g.NUN.ME.EZEN×KASKAL|	𒊩𒌆𒉽𒅊𒉣𒈨𒂬	sux
dilmunx	|SAL.TUK|	𒊩𒌇	sux
eribx	|SAL.UD|	𒊩𒌓	sux
muru5	|SAL.UD.EDIN|	𒊩𒌓𒂔	sux
murum5	|SAL.UD.EDIN|	𒊩𒌓𒂔	sux
LAK521	|SAL.UR|	𒊩𒌨	sux
nig	|SAL.UR|	𒊩𒌨	sux
nij	|SAL.UR|	𒊩𒌨	sux
nik	|SAL.UR|	𒊩𒌨	sux
niq	|SAL.UR|	𒊩𒌨	sux
gidlam4	|SAL.UŠ|	𒊩𒍑	sux
gitlam4	|SAL.UŠ|	𒊩𒍑	sux
jidlam4	|SAL.UŠ|	𒊩𒍑	sux
nidalam4	|SAL.UŠ|	𒊩𒍑	sux
nidlam4	|SAL.UŠ|	𒊩𒍑	sux
nintah3	|SAL.UŠ|	𒊩𒍑	sux
nita3	|SAL.UŠ|	𒊩𒍑	sux
nitah3	|SAL.UŠ|	𒊩𒍑	sux
nitadam4	|SAL.UŠ|	𒊩𒍑	sux
nitalam4	|SAL.UŠ|	𒊩𒍑	sux
nitlam4	|SAL.UŠ|	𒊩𒍑	sux
gidlam	|SAL.UŠ.DAM|	𒊩𒍑𒁮	sux
gitlam	|SAL.UŠ.DAM|	𒊩𒍑𒁮	sux
jidlam	|SAL.UŠ.DAM|	𒊩𒍑𒁮	sux
jitlam	|SAL.UŠ.DAM|	𒊩𒍑𒁮	sux
mada	|SAL.UŠ.DAM|	𒊩𒍑𒁮	sux
mudnax	|SAL.UŠ.DAM|	𒊩𒍑𒁮	sux
murub5	|SAL.UŠ.DAM|	𒊩𒍑𒁮	sux
nidalam	|SAL.UŠ.DAM|	𒊩𒍑𒁮	sux
nidlam	|SAL.UŠ.DAM|	𒊩𒍑𒁮	sux
nitadam	|SAL.UŠ.DAM|	𒊩𒍑𒁮	sux
nitalam	|SAL.UŠ.DAM|	𒊩𒍑𒁮	sux
nitlam	|SAL.UŠ.DAM|	𒊩𒍑𒁮	sux
gambi	|SAL.UŠ.DI|	𒊩𒍑𒁲	sux
gammu	|SAL.UŠ.DI|	𒊩𒍑𒁲	sux
gamu	|SAL.UŠ.DI|	𒊩𒍑𒁲	sux
munussa	|SAL.UŠ.DI|	𒊩𒍑𒁲	sux
mussa	|SAL.UŠ.DI|	𒊩𒍑𒁲	sux
LAK175	SANGA₂	𒊫	sux
saja2	SANGA₂	𒊫	sux
sanga2	SANGA₂	𒊫	sux
saja7~a	|GA.BALAG|	𒂵𒁆	sux
sajja7~a	|GA.BALAG|	𒂵𒁆	sux
sanga7~a	|GA.BALAG|	𒂵𒁆	sux
saja6~c	|GA.MA₂.IGI@g|	𒂵𒈣𒅊	sux
sagga6~c	|GA.MA₂.IGI@g|	𒂵𒈣𒅊	sux
sanga6~c	|GA.MA₂.IGI@g|	𒂵𒈣𒅊	sux
sangu6~c	|GA.MA₂.IGI@g|	𒂵𒈣𒅊	sux
sajax~e	|GA.UZ₃|	𒂵𒍚	sux
sangax~e	|GA.UZ₃|	𒂵𒍚	sux
sajax~f	|GA.UZ₃.HI|	𒂵𒍚𒄭	sux
sangax~f	|GA.UZ₃.HI|	𒂵𒍚𒄭	sux
saja5~g	|GA.UZ₃.IGI@g|	𒂵𒍚𒅊	sux
sagga5~g	|GA.UZ₃.IGI@g|	𒂵𒍚𒅊	sux
sanga5~g	|GA.UZ₃.IGI@g|	𒂵𒍚𒅊	sux
sangu5~g	|GA.UZ₃.IGI@g|	𒂵𒍚𒅊	sux
saja4~h	|IL₂.DUB₂|	𒅍𒂀	sux
sagga4~h	|IL₂.DUB₂|	𒅍𒂀	sux
sanga4~h	|IL₂.DUB₂|	𒅍𒂀	sux
sangu4~h	|IL₂.DUB₂|	𒅍𒂀	sux
sagga2~i	|IL₂.MA₂.DUB₂|	𒅍𒈣𒂀	sux
sajja2~i	|IL₂.MA₂.DUB₂|	𒅍𒈣𒂀	sux
sangu2~i	|IL₂.MA₂.DUB₂|	𒅍𒈣𒂀	sux
saja3~j	|IL₂.MA₂.IGI@g|	𒅍𒈣𒅊	sux
sagga3~j	|IL₂.MA₂.IGI@g|	𒅍𒈣𒅊	sux
sanga3~j	|IL₂.MA₂.IGI@g|	𒅍𒈣𒅊	sux
sangu3~j	|IL₂.MA₂.IGI@g|	𒅍𒈣𒅊	sux
LAK215	SAR	𒊬	sux
kiri6	SAR	𒊬	sux
ma4	SAR	𒊬	sux
mu2	SAR	𒊬	sux
mud6	SAR	𒊬	sux
nisax	SAR	𒊬	sux
nisix	SAR	𒊬	sux
nisig	SAR	𒊬	sux
nissa	SAR	𒊬	sux
nica	SAR	𒊬	sux
sahar2	SAR	𒊬	sux
sakar	SAR	𒊬	sux
sar	SAR	𒊬	sux
sara	SAR	𒊬	sux
sarix	SAR	𒊬	sux
se15	SAR	𒊬	sux
si15	SAR	𒊬	sux
sigx	SAR	𒊬	sux
śar	SAR	𒊬	sux
ca8	SAR	𒊬	sux
cakar	SAR	𒊬	sux
car	SAR	𒊬	sux
cara7	SAR	𒊬	sux
cer9	SAR	𒊬	sux
cir9	SAR	𒊬	sux
sarsa	|SAR.SAR|	𒊬𒊬	sux
LAK83	SI	𒋛	sux
hux	SI	𒋛	sux
se	SI	𒋛	sux
seg9	SI	𒋛	sux
si	SI	𒋛	sux
sig9	SI	𒋛	sux
śe	SI	𒋛	sux
śi	SI	𒋛	sux
ce2	SI	𒋛	sux
ci2	SI	𒋛	sux
s,i3	SI	𒋛	sux
LAK84	|SI.A|	𒋛𒀀	sux
dir	|SI.A|	𒋛𒀀	sux
diri	|SI.A|	𒋛𒀀	sux
dirig	|SI.A|	𒋛𒀀	sux
du26	|SI.A|	𒋛𒀀	sux
mal2	|SI.A|	𒋛𒀀	sux
nindar	|SI.A|	𒋛𒀀	sux
sa5	|SI.A|	𒋛𒀀	sux
six	|SI.A|	𒋛𒀀	sux
ter4	|SI.A|	𒋛𒀀	sux
ter	|SI.A|	𒋛𒀀	sux
tir4	|SI.A|	𒋛𒀀	sux
tir	|SI.A|	𒋛𒀀	sux
uc15	|SI.A|	𒋛𒀀	sux
ucub	|SI.A|	𒋛𒀀	sux
sabu	|SI.A.BUR₂|	𒋛𒀀𒁔	sux
LAK86	SI@g	𒋜	sux
gunux	SI@g	𒋜	sux
sa11	SI@g	𒋜	sux
si4	SI@g	𒋜	sux
su4	SI@g	𒋜	sux
śi2	SI@g	𒋜	sux
śu2	SI@g	𒋜	sux
usan4	SI@g	𒋜	sux
su9	|SI@g.A|	𒋜𒀀	sux
bek	SIG	𒋝	sux
big	SIG	𒋝	sux
bik	SIG	𒋝	sux
epig	SIG	𒋝	sux
ipig	SIG	𒋝	sux
pik	SIG	𒋝	sux
piq	SIG	𒋝	sux
se11	SIG	𒋝	sux
seg	SIG	𒋝	sux
sek	SIG	𒋝	sux
si11	SIG	𒋝	sux
sig	SIG	𒋝	sux
siga	SIG	𒋝	sux
sik	SIG	𒋝	sux
siq	SIG	𒋝	sux
śe2	SIG	𒋝	sux
śi3	SIG	𒋝	sux
cag6	SIG	𒋝	sux
cak6	SIG	𒋝	sux
cex	SIG	𒋝	sux
cej	SIG	𒋝	sux
cek	SIG	𒋝	sux
ci3	SIG	𒋝	sux
cig	SIG	𒋝	sux
cik	SIG	𒋝	sux
ciq	SIG	𒋝	sux
zig2	SIG	𒋝	sux
zik2	SIG	𒋝	sux
ziq2	SIG	𒋝	sux
mudrax	|SIG.MU.BU|	𒋝𒈬𒁍	sux
munzerx	|SIG.MU.BU|	𒋝𒈬𒁍	sux
LAK188	SIG₄	𒋞	sux
bar5	SIG₄	𒋞	sux
eger6	SIG₄	𒋞	sux
egir6	SIG₄	𒋞	sux
gar8	SIG₄	𒋞	sux
gara8	SIG₄	𒋞	sux
jar8	SIG₄	𒋞	sux
kulla	SIG₄	𒋞	sux
kullux	SIG₄	𒋞	sux
murgu	SIG₄	𒋞	sux
seg4	SIG₄	𒋞	sux
sig4	SIG₄	𒋞	sux
ce27	SIG₄	𒋞	sux
ceb4	SIG₄	𒋞	sux
ced16	SIG₄	𒋞	sux
ceg12	SIG₄	𒋞	sux
banda5	|SIG₄.IDIM|	𒋞𒅂	sux
uru9	|SIG₄.IDIM|	𒋞𒅂	sux
urumx	|SIG₄.IDIM|	𒋞𒅂	sux
lahhucux	|SIG₄.SIG₄.ŠU₂|	𒋞𒋞𒋙	sux
guhcu	|SIG₄&SIG₄.ŠU₂|	𒋟	sux
hix	|SIG₄&SIG₄.ŠU₂|	𒋟	sux
lahhucu	|SIG₄&SIG₄.ŠU₂|	𒋟	sux
cikahara	|SIG₄&SIG₄.ŠU₂|	𒋟	sux
LAK793	SIK₂	𒋠	sux
MZL816	SIK₂	𒋠	sux
seg2	SIK₂	𒋠	sux
sig2	SIK₂	𒋠	sux
sik2	SIK₂	𒋠	sux
siki	SIK₂	𒋠	sux
cek2	SIK₂	𒋠	sux
ceq2	SIK₂	𒋠	sux
cik2	SIK₂	𒋠	sux
ciq2	SIK₂	𒋠	sux
dibx	|SIK₂.AŠ|	𒋠𒀸	sux
ganax	|SIK₂.AŠ|	𒋠𒀸	sux
ganamx	|SIK₂.AŠ|	𒋠𒀸	sux
gayayux	|SIK₂.AŠ|	𒋠𒀸	sux
laharx	|SIK₂.AŠ|	𒋠𒀸	sux
lahrux	|SIK₂.AŠ|	𒋠𒀸	sux
mudru4	|SIK₂.AŠ|	𒋠𒀸	sux
mudrum4	|SIK₂.AŠ|	𒋠𒀸	sux
curimx	|SIK₂.AŠ|	𒋠𒀸	sux
curux	|SIK₂.AŠ|	𒋠𒀸	sux
curumx	|SIK₂.AŠ|	𒋠𒀸	sux
curunx	|SIK₂.AŠ|	𒋠𒀸	sux
ux	|SIK₂.AŠ|	𒋠𒀸	sux
usx	|SIK₂.AŠ|	𒋠𒀸	sux
wax	|SIK₂.AŠ|	𒋠𒀸	sux
mudra5	|SIK₂.BU|	𒋠𒁍	sux
mudru5	|SIK₂.BU|	𒋠𒁍	sux
suluhu2	|SIK₂.BU|	𒋠𒁍	sux
sulumhi2	|SIK₂.BU|	𒋠𒁍	sux
zuluhu2	|SIK₂.BU|	𒋠𒁍	sux
zulumhi2	|SIK₂.BU|	𒋠𒁍	sux
LAK668	|SIK₂.LAM|	𒋠𒇴	sux
adkin	|SIK₂.LAM|	𒋠𒇴	sux
ac6	|SIK₂.LAM|	𒋠𒇴	sux
sikin	|SIK₂.LAM|	𒋠𒇴	sux
cikin3	|SIK₂.LAM|	𒋠𒇴	sux
udkinx	|SIK₂.LAM|	𒋠𒇴	sux
ac5	|SIK₂.LAM.SUHUR|	𒋠𒇴𒋦	sux
munsub2	|SIK₂.LAM.SUHUR|	𒋠𒇴𒋦	sux
muncub2	|SIK₂.LAM.SUHUR|	𒋠𒇴𒋦	sux
musub2	|SIK₂.LAM.SUHUR|	𒋠𒇴𒋦	sux
muzer	|SIK₂.LAM.SUHUR|	𒋠𒇴𒋦	sux
muzir	|SIK₂.LAM.SUHUR|	𒋠𒇴𒋦	sux
sagmunzer	|SIK₂.MU.BU|	𒋠𒈬𒁍	sux
sagmunzir	|SIK₂.MU.BU|	𒋠𒈬𒁍	sux
suluhu	|SIK₂.SUD|	𒋠𒋤	sux
sulumhi	|SIK₂.SUD|	𒋠𒋤	sux
zuluhu	|SIK₂.SUD|	𒋠𒋤	sux
zulumhi	|SIK₂.SUD|	𒋠𒋤	sux
munsubx	|SIK₂.SUHUR|	𒋠𒋦	sux
hamanzerx	|SIK₂.PA.IB|	𒋠𒉺𒅁	sux
hamanzirx	|SIK₂.PA.IB|	𒋠𒉺𒅁	sux
LAK269	SILA₃	𒋡	sux
MZL99	SILA₃	𒋡	sux
qû	SILA₃	𒋡	sux
ga5	SILA₃	𒋡	sux
ka4	SILA₃	𒋡	sux
qa	SILA₃	𒋡	sux
sal4	SILA₃	𒋡	sux
sala4	SILA₃	𒋡	sux
sil3	SILA₃	𒋡	sux
sila3	SILA₃	𒋡	sux
cal2	SILA₃	𒋡	sux
sagi	|SILA₃.ŠU.GABA|	𒋡𒋗𒃮	sux
cagia	|SILA₃.ŠU.GABA|	𒋡𒋗𒃮	sux
sagix~a	|SILA₃.GABA|	𒋡𒃮	sux
LAK293	SU	𒋢	sux
MZL16	SU	𒋢	sux
guc	SU	𒋢	sux
kus	SU	𒋢	sux
kuc	SU	𒋢	sux
kuz	SU	𒋢	sux
su	SU	𒋢	sux
sug6	SU	𒋢	sux
sum3	SU	𒋢	sux
śu	SU	𒋢	sux
cu11	SU	𒋢	sux
aktum2	|SU.A|	𒋢𒀀	sux
ugnimx	|SU.KI.LU.EŠ₂.KI|	𒋢𒆠𒇻𒂠𒆠	sux
sudx	|SU.KUR|	𒋢𒆳	sux
LAK294	|SU.KUR.RU|	𒋢𒆳𒊒	sux
sud3	|SU.KUR.RU|	𒋢𒆳𒊒	sux
curipak	|SU.KUR.RU|	𒋢𒆳𒊒	sux
curippak	|SU.KUR.RU|	𒋢𒆳𒊒	sux
curupak	|SU.KUR.RU|	𒋢𒆳𒊒	sux
curuppag	|SU.KUR.RU|	𒋢𒆳𒊒	sux
curuppak	|SU.KUR.RU|	𒋢𒆳𒊒	sux
sudx	|SU.RU×KUR|	𒋢	sux
curuppakx	|SU.RU×KUR|	𒋢	sux
e6	|SU&SU|	𒋣	sux
e6-a	|SU&SU.A|	𒋣𒀀	sux
sar4	SUD	𒋤	sux
ser	SUD	𒋤	sux
six	SUD	𒋤	sux
sir	SUD	𒋤	sux
su3	SUD	𒋤	sux
sud	SUD	𒋤	sux
sug4	SUD	𒋤	sux
śu3	SUD	𒋤	sux
cir8	SUD	𒋤	sux
cux	SUD	𒋤	sux
cud	SUD	𒋤	sux
cut	SUD	𒋤	sux
cut	SUD	𒋤	sux
cuz	SUD	𒋤	sux
zir0	SUD	𒋤	sux
zir4	SUD	𒋤	sux
zu6	SUD	𒋤	sux
sugx	|SUD.PA.EL|	𒋤𒉺𒂖	sux
LAK74	SUD₂	𒋥	sux
MZL139	SUD₂	𒋥	sux
adarx	SUD₂	𒋥	sux
ildag	SUD₂	𒋥	sux
ra4	SUD₂	𒋥	sux
rad	SUD₂	𒋥	sux
rat	SUD₂	𒋥	sux
rata	SUD₂	𒋥	sux
rat	SUD₂	𒋥	sux
rit2	SUD₂	𒋥	sux
rud	SUD₂	𒋥	sux
rut	SUD₂	𒋥	sux
sud2	SUD₂	𒋥	sux
susx	SUD₂	𒋥	sux
susu	SUD₂	𒋥	sux
cidax	SUD₂	𒋥	sux
cita3	SUD₂	𒋥	sux
citanx	SUD₂	𒋥	sux
cucu	SUD₂	𒋥	sux
zusu	SUD₂	𒋥	sux
LAK227	SUHUR	𒋦	sux
suh2	SUHUR	𒋦	sux
suhur	SUHUR	𒋦	sux
sumur2	SUHUR	𒋦	sux
ubi2	SUHUR	𒋦	sux
ugab	SUHUR	𒋦	sux
LAK197	SUM	𒋧	sux
ari6	SUM	𒋧	sux
sar8	SUM	𒋧	sux
se3	SUM	𒋧	sux
seg10	SUM	𒋧	sux
si3	SUM	𒋧	sux
sig10	SUM	𒋧	sux
sik10	SUM	𒋧	sux
sim2	SUM	𒋧	sux
su12	SUM	𒋧	sux
sum	SUM	𒋧	sux
sumu	SUM	𒋧	sux
sun3	SUM	𒋧	sux
śum2	SUM	𒋧	sux
ce19	SUM	𒋧	sux
cum2	SUM	𒋧	sux
cumu2	SUM	𒋧	sux
cun4	SUM	𒋧	sux
zar3	SUM	𒋧	sux
/zej/	SUM	𒋧	sux
LAK226	SUMAŠ	𒋨	sux
sumac	SUMAŠ	𒋨	sux
ucbar4	SUMAŠ	𒋨	sux
ucbur4	SUMAŠ	𒋨	sux
ucbarx	|SUMAŠ.MAŠ|	𒋨𒈦	sux
gudu11	|SUMAŠ.ME|	𒋨𒈨	sux
gudug2	|SUMAŠ.ME|	𒋨𒈨	sux
luhcax	|SUMAŠ.ME|	𒋨𒈨	sux
LAK182	SUR	𒋩	sux
sur	SUR	𒋩	sux
sura	SUR	𒋩	sux
śur	SUR	𒋩	sux
cur	SUR	𒋩	sux
tir3	SUR	𒋩	sux
sur9	SUR₉	𒋪	sux
sura9	SUR₉	𒋪	sux
surru	SUR₉	𒋪	sux
zur2	SUR₉	𒋪	sux
LAK170	ŠA	𒊭	sux
MZL566	ŠA	𒊭	sux
ara	ŠA	𒊭	sux
en8	ŠA	𒊭	sux
li5	ŠA	𒊭	sux
na5	ŠA	𒊭	sux
sa20	ŠA	𒊭	sux
ca	ŠA	𒊭	sux
zur8	ŠA	𒊭	sux
LAK443	ŠA₃	𒊮	sux
MZL599	ŠA₃	𒊮	sux
didala	ŠA₃	𒊮	sux
lib3	ŠA₃	𒊮	sux
lip3	ŠA₃	𒊮	sux
pecx	ŠA₃	𒊮	sux
sa19	ŠA₃	𒊮	sux
ca3	ŠA₃	𒊮	sux
cab2	ŠA₃	𒊮	sux
cag4	ŠA₃	𒊮	sux
calambi	ŠA₃	𒊮	sux
kadrax	|ŠA₃.A|	𒊮𒀀	sux
lidx	|ŠA₃.DIŠ|	𒊮𒁹	sux
lidda2	|ŠA₃.DIŠ|	𒊮𒁹	sux
anzalub	|ŠA₃.GI|	𒊮𒄀	sux
buglu	|ŠA₃.GI|	𒊮𒄀	sux
hanzalub	|ŠA₃.GI|	𒊮𒄀	sux
puglu	|ŠA₃.GI|	𒊮𒄀	sux
calambix	|ŠA₃.GIŠ.SAR|	𒊮𒄑𒊬	sux
ichara2	|ŠA₃.LAGAB|	𒊮𒆸	sux
tibula3	|ŠA₃.MIN.DI|	𒊮𒈫𒁲	sux
tigidla3	|ŠA₃.MIN.DI|	𒊮𒈫𒁲	sux
tibula2	|ŠA₃.MIN.KASKAL|	𒊮𒈫𒆜	sux
tigidla2	|ŠA₃.MIN.KASKAL|	𒊮𒈫𒆜	sux
tibula	|ŠA₃.MIN.TAR|	𒊮𒈫𒋻	sux
tigidlax	|ŠA₃.MIN.TAR|	𒊮𒈫𒋻	sux
lambi	|ŠA₃.SAR|	𒊮𒊬	sux
tigidla	|ŠA₃.TAR|	𒊮𒋻	sux
ber7	|ŠA₃×A|	𒊯	sux
bir7	|ŠA₃×A|	𒊯	sux
ickila	|ŠA₃×A|	𒊯	sux
ickili	|ŠA₃×A|	𒊯	sux
icla	|ŠA₃×A|	𒊯	sux
icli	|ŠA₃×A|	𒊯	sux
kiri4	|ŠA₃×A|	𒊯	sux
pec4	|ŠA₃×A|	𒊯	sux
pic4	|ŠA₃×A|	𒊯	sux
sur4	|ŠA₃×A|	𒊯	sux
habburudax	|ŠA₃×BAD|	𒊰	sux
habrud3	|ŠA₃×BAD|	𒊰	sux
habruda3	|ŠA₃×BAD|	𒊰	sux
nanam2	|ŠA₃×BAD|	𒊰	sux
nanam	|ŠA₃×NE|	𒊲	sux
nenim	|ŠA₃×NE|	𒊲	sux
ninim	|ŠA₃×NE|	𒊲	sux
gudu5	|ŠA₃×ŠU₂|	𒊳	sux
cax	|ŠA₃×ŠU₂|	𒊳	sux
pec13	|ŠA₃×TUR|	𒊴	sux
habburudax	|ŠA₃×U|	𒊵	sux
habrud4	|ŠA₃×U|	𒊵	sux
habruda4	|ŠA₃×U|	𒊵	sux
ber6	|ŠA₃×(U.A)|	𒊶	sux
bir6	|ŠA₃×(U.A)|	𒊶	sux
LAK196	ŠA₆	𒊷	sux
a10	ŠA₆	𒊷	sux
gecimmar	ŠA₆	𒊷	sux
gecnimbar	ŠA₆	𒊷	sux
gicimmar	ŠA₆	𒊷	sux
jecimmar	ŠA₆	𒊷	sux
jecnimbar	ŠA₆	𒊷	sux
jicimmar	ŠA₆	𒊷	sux
jicnimbar	ŠA₆	𒊷	sux
had3	ŠA₆	𒊷	sux
hud4	ŠA₆	𒊷	sux
nimbar	ŠA₆	𒊷	sux
pa9	ŠA₆	𒊷	sux
sa6	ŠA₆	𒊷	sux
sag9	ŠA₆	𒊷	sux
seg6	ŠA₆	𒊷	sux
sig6	ŠA₆	𒊷	sux
ca6	ŠA₆	𒊷	sux
cag5	ŠA₆	𒊷	sux
suhucx	|ŠA₆.TUR|	𒊷𒌉	sux
cab0	ŠAB₆	𒊸	sux
cap0	ŠAB₆	𒊸	sux
cab6	ŠAB₆	𒊸	sux
cap6	ŠAB₆	𒊸	sux
canaba	ŠANABI	𒑛	sux
canabi	ŠANABI	𒑛	sux
canapi	ŠANABI	𒑛	sux
cudaminx	ŠANABI	𒑛	sux
2/3(dic)	ŠANABI	𒑛	sux
2/3(dic@c)	ŠANABI	𒑛	sux
LAK809	ŠAR₂	𒊹	sux
sar2	ŠAR₂	𒊹	sux
sara2	ŠAR₂	𒊹	sux
sare2	ŠAR₂	𒊹	sux
car2	ŠAR₂	𒊹	sux
cara6	ŠAR₂	𒊹	sux
cargal	ŠAR₂	𒊹	sux
1(car2)	ŠAR₂	𒊹	sux
1(car2@c)	ŠAR₂	𒊹	sux
1(cargal)	ŠAR₂	𒊹	sux
1(cargal@c)	ŠAR₂	𒊹	sux
car2@c	ŠAR₂	𒊹	sux
cargaldic	|ŠAR₂×(GAL.DIŠ)|	𒐲	sux
cargalmin	|ŠAR₂×(GAL.MIN)|	𒐳	sux
LAK199	ŠE	𒊺	sux
acnan2	ŠE	𒊺	sux
nigx	ŠE	𒊺	sux
niga	ŠE	𒊺	sux
nigan	ŠE	𒊺	sux
nigu	ŠE	𒊺	sux
sagx	ŠE	𒊺	sux
ce	ŠE	𒊺	sux
u20	ŠE	𒊺	sux
munu6	|ŠE.BULUG|	𒊺𒁑	sux
LAK201	|ŠE.HU|	𒊻	sux
bazbazx	|ŠE.HU|	𒊻	sux
us	|ŠE.HU|	𒊻	sux
uc10	|ŠE.HU|	𒊻	sux
us,	|ŠE.HU|	𒊻	sux
uz	|ŠE.HU|	𒊻	sux
uza	|ŠE.HU|	𒊻	sux
uzu3	|ŠE.HU|	𒊻	sux
bibad	|ŠE.HU.TUR|	𒊺𒄷𒌉	sux
bibe	|ŠE.HU.TUR|	𒊺𒄷𒌉	sux
isinx	|ŠE.IGI.TUR|	𒊺𒅆𒌉	sux
henbur2	|ŠE.KAK|	𒊺𒆕	sux
gurx	|ŠE.KIN|	𒊺𒆥	sux
kinx	|ŠE.KIN|	𒊺𒆥	sux
sagax	|ŠE.KIN|	𒊺𒆥	sux
sigx	|ŠE.KIN|	𒊺𒆥	sux
gurx	|ŠE.KIN.KIN|	𒊺𒆥𒆥	sux
sagax	|ŠE.KIN.KIN|	𒊺𒆥𒆥	sux
cesag	|ŠE.LUGAL|	𒊺𒈗	sux
nidaba	|ŠE.NAGA|	𒊺𒉀	sux
nisaba	|ŠE.NAGA|	𒊺𒉀	sux
tux	|ŠE.NAGA|	𒊺𒉀	sux
cucx	|ŠE.NAM₂|	𒊺𒉇	sux
LAK204	|ŠE.NUN&NUN|	𒌁	sux
MZL587	|ŠE.NUN&NUN|	𒌁	sux
dir4	|ŠE.NUN&NUN|	𒌁	sux
ezina3	|ŠE.NUN&NUN|	𒌁	sux
ezinu3	|ŠE.NUN&NUN|	𒌁	sux
gamun2	|ŠE.NUN&NUN|	𒌁	sux
ninni8	|ŠE.NUN&NUN|	𒌁	sux
panax	|ŠE.NUN&NUN|	𒌁	sux
qicat	|ŠE.NUN&NUN|	𒌁	sux
cabu	|ŠE.NUN&NUN|	𒌁	sux
ce15	|ŠE.NUN&NUN|	𒌁	sux
ter	|ŠE.NUN&NUN|	𒌁	sux
ter5	|ŠE.NUN&NUN|	𒌁	sux
tir	|ŠE.NUN&NUN|	𒌁	sux
tir5	|ŠE.NUN&NUN|	𒌁	sux
ezinax	|(ŠE.NUN&NUN)×TAK₄|	𒌂	sux
ezinux	|(ŠE.NUN&NUN)×TAK₄|	𒌂	sux
garadin6	|(ŠE.NUN&NUN)&(ŠE.NUN&NUN)|	𒌃	sux
karadin6	|(ŠE.NUN&NUN)&(ŠE.NUN&NUN)|	𒌃	sux
nenni5	|(ŠE.NUN&NUN)&(ŠE.NUN&NUN)|	𒌃	sux
ninni5	|(ŠE.NUN&NUN)&(ŠE.NUN&NUN)|	𒌃	sux
LAK419	|(ŠE.NUN&NUN)&(ŠE.NUN&NUN).GAD&GAD.GAR&GAR|	𒌄	sux
garadin	|(ŠE.NUN&NUN)&(ŠE.NUN&NUN).GAD&GAD.GAR&GAR|	𒌄	sux
karadin	|(ŠE.NUN&NUN)&(ŠE.NUN&NUN).GAD&GAD.GAR&GAR|	𒌄	sux
garadin4	|(ŠE.NUN&NUN)&(ŠE.NUN&NUN).LAGAB|	𒌃𒆸	sux
garadin4	|(ŠE.NUN&NUN)&(ŠE.NUN&NUN).LAGAB.LAGAB|	𒌃𒆸𒆸	sux
karadin4	|(ŠE.NUN&NUN)&(ŠE.NUN&NUN).LAGAB.LAGAB|	𒌃𒆸𒆸	sux
munux	|ŠE.PAP.PAP|	𒊺𒉽𒉽	sux
ubix	|ŠE.SUHUR|	𒊺𒋦	sux
gurx	|ŠE.ŠE.KIN|	𒊺𒊺𒆥	sux
cemuc	|ŠE.ŠEŠ|	𒊺𒋀	sux
acnan	|ŠE.ŠE.NUN&NUN|	𒊺𒊺𒉪	sux
acnana	|ŠE.ŠE.NUN&NUN|	𒊺𒊺𒉪	sux
ezennax	|ŠE.ŠE.NUN&NUN|	𒊺𒊺𒉪	sux
ezim2	|ŠE.ŠE.NUN&NUN|	𒊺𒊺𒉪	sux
ezin2	|ŠE.ŠE.NUN&NUN|	𒊺𒊺𒉪	sux
ezina2	|ŠE.ŠE.NUN&NUN|	𒊺𒊺𒉪	sux
ezinu2	|ŠE.ŠE.NUN&NUN|	𒊺𒊺𒉪	sux
garadin2	|ŠE&ŠE.GAD&GAD.GAR&GAR|	𒊼	sux
karadin2	|ŠE&ŠE.GAD&GAD.GAR&GAR|	𒊼	sux
garadin3	|ŠE&ŠE.TAB&TAB.GAR&GAR|	𒊽	sux
karadin3	|ŠE&ŠE.TAB&TAB.GAR&GAR|	𒊽	sux
kici6	ŠEG₉	𒊾	sux
sa21	ŠEG₉	𒊾	sux
seg14	ŠEG₉	𒊾	sux
segga	ŠEG₉	𒊾	sux
sig14	ŠEG₉	𒊾	sux
sigga	ŠEG₉	𒊾	sux
ceg9	ŠEG₉	𒊾	sux
cega9	ŠEG₉	𒊾	sux
cej9	ŠEG₉	𒊾	sux
cenx	ŠEG₉	𒊾	sux
cenbar	ŠEG₉	𒊾	sux
cegga	ŠEG₉	𒊾	sux
sabar	|ŠEG₉.BAR|	𒊾𒁇	sux
LAK713	ŠEN	𒊿	sux
MZL17	ŠEN	𒊿	sux
dur10	ŠEN	𒊿	sux
rik4	ŠEN	𒊿	sux
rug	ŠEN	𒊿	sux
ruk	ŠEN	𒊿	sux
ruq	ŠEN	𒊿	sux
ruqu	ŠEN	𒊿	sux
san2	ŠEN	𒊿	sux
sun6	ŠEN	𒊿	sux
cen	ŠEN	𒊿	sux
cin	ŠEN	𒊿	sux
cun	ŠEN	𒊿	sux
zin	ŠEN	𒊿	sux
LAK32	ŠEŠ	𒋀	sux
MZL535	ŠEŠ	𒋀	sux
ah2	ŠEŠ	𒋀	sux
aha2	ŠEŠ	𒋀	sux
ahi	ŠEŠ	𒋀	sux
mun4	ŠEŠ	𒋀	sux
muc5	ŠEŠ	𒋀	sux
nan	ŠEŠ	𒋀	sux
sas	ŠEŠ	𒋀	sux
ses	ŠEŠ	𒋀	sux
sis	ŠEŠ	𒋀	sux
sic	ŠEŠ	𒋀	sux
cas	ŠEŠ	𒋀	sux
cac	ŠEŠ	𒋀	sux
cas,	ŠEŠ	𒋀	sux
ce16	ŠEŠ	𒋀	sux
ces	ŠEŠ	𒋀	sux
ces,	ŠEŠ	𒋀	sux
cec	ŠEŠ	𒋀	sux
cic	ŠEŠ	𒋀	sux
cis,	ŠEŠ	𒋀	sux
ciz	ŠEŠ	𒋀	sux
zax	ŠEŠ	𒋀	sux
zahx	ŠEŠ	𒋀	sux
ura16	|ŠEŠ.AB|	𒋀𒀊	sux
uram2	|ŠEŠ.AB|	𒋀𒀊	sux
uri5	|ŠEŠ.AB|	𒋀𒀊	sux
urim5	|ŠEŠ.AB|	𒋀𒀊	sux
uru15	|ŠEŠ.AB|	𒋀𒀊	sux
urum6	|ŠEŠ.AB|	𒋀𒀊	sux
ura15	|ŠEŠ.AB@g|	𒋀𒀕	sux
uram	|ŠEŠ.AB@g|	𒋀𒀕	sux
uri2	|ŠEŠ.AB@g|	𒋀𒀕	sux
urim2	|ŠEŠ.AB@g|	𒋀𒀕	sux
uru14	|ŠEŠ.AB@g|	𒋀𒀕	sux
urum5	|ŠEŠ.AB@g|	𒋀𒀕	sux
urinx	|ŠEŠ.HU.HU|	𒋀𒄷𒄷	sux
dux	|ŠEŠ.IB|	𒋀𒅁	sux
dugx	|ŠEŠ.IB|	𒋀𒅁	sux
LAK33	|ŠEŠ.KI|	𒋀𒆠	sux
nan2	|ŠEŠ.KI|	𒋀𒆠	sux
nanna	|ŠEŠ.KI|	𒋀𒆠	sux
cec2	ŠEŠ₂	𒋁	sux
ce8	ŠEŠ₂	𒋁	sux
cic2	ŠEŠ₂	𒋁	sux
MZL100	ŠEŠLAM	𒋂	sux
ceclam	ŠEŠLAM	𒋂	sux
LAK711	ŠID	𒋃	sux
ag3	ŠID	𒋃	sux
aj3	ŠID	𒋃	sux
ak3	ŠID	𒋃	sux
aka3	ŠID	𒋃	sux
alal2	ŠID	𒋃	sux
alamu2	ŠID	𒋃	sux
almu2	ŠID	𒋃	sux
bisag2	ŠID	𒋃	sux
bisaj2	ŠID	𒋃	sux
bisan2	ŠID	𒋃	sux
dilib	ŠID	𒋃	sux
dim12	ŠID	𒋃	sux
elal2	ŠID	𒋃	sux
gir13	ŠID	𒋃	sux
gud9	ŠID	𒋃	sux
ka9	ŠID	𒋃	sux
kas7	ŠID	𒋃	sux
kid4	ŠID	𒋃	sux
kiri8	ŠID	𒋃	sux
la10	ŠID	𒋃	sux
lag	ŠID	𒋃	sux
lak	ŠID	𒋃	sux
laka	ŠID	𒋃	sux
laq	ŠID	𒋃	sux
lik2	ŠID	𒋃	sux
liq2	ŠID	𒋃	sux
mer4	ŠID	𒋃	sux
nesag2	ŠID	𒋃	sux
nesaj2	ŠID	𒋃	sux
nisag2	ŠID	𒋃	sux
nisaj2	ŠID	𒋃	sux
pa8	ŠID	𒋃	sux
pisag2	ŠID	𒋃	sux
pisaj2	ŠID	𒋃	sux
pisan2	ŠID	𒋃	sux
sagga	ŠID	𒋃	sux
saja8	ŠID	𒋃	sux
sajja	ŠID	𒋃	sux
sanga	ŠID	𒋃	sux
sangu	ŠID	𒋃	sux
sid2	ŠID	𒋃	sux
sila11	ŠID	𒋃	sux
silag	ŠID	𒋃	sux
silaj	ŠID	𒋃	sux
sinx	ŠID	𒋃	sux
sit2	ŠID	𒋃	sux
subx	ŠID	𒋃	sux
canga	ŠID	𒋃	sux
ce14	ŠID	𒋃	sux
ced	ŠID	𒋃	sux
cet	ŠID	𒋃	sux
cid	ŠID	𒋃	sux
cit	ŠID	𒋃	sux
cita5	ŠID	𒋃	sux
citi	ŠID	𒋃	sux
citim2	ŠID	𒋃	sux
cit	ŠID	𒋃	sux
cub6	ŠID	𒋃	sux
cutumx	ŠID	𒋃	sux
cud4	ŠID	𒋃	sux
cudum	ŠID	𒋃	sux
te6	ŠID	𒋃	sux
tu14	ŠID	𒋃	sux
tuba3	ŠID	𒋃	sux
ubisag	ŠID	𒋃	sux
umbisag	ŠID	𒋃	sux
umbisaj	ŠID	𒋃	sux
uttu2	ŠID	𒋃	sux
utu2	ŠID	𒋃	sux
zadri	ŠID	𒋃	sux
zadru	ŠID	𒋃	sux
zandar	ŠID	𒋃	sux
zandara	ŠID	𒋃	sux
rigx	|ŠID.RU|	𒋃𒊒	sux
alax	|ŠID×A|	𒋄	sux
alal	|ŠID×A|	𒋄	sux
alalmu	|ŠID×A|	𒋄	sux
alamu	|ŠID×A|	𒋄	sux
almu	|ŠID×A|	𒋄	sux
bisag3	|ŠID×A|	𒋄	sux
bisaj3	|ŠID×A|	𒋄	sux
bisan3	|ŠID×A|	𒋄	sux
bizeg3	|ŠID×A|	𒋄	sux
bizem3	|ŠID×A|	𒋄	sux
elal	|ŠID×A|	𒋄	sux
hubhub	|ŠID×A|	𒋄	sux
kirbanu	|ŠID×A|	𒋄	sux
mezeg	|ŠID×A|	𒋄	sux
mezej	|ŠID×A|	𒋄	sux
mezem	|ŠID×A|	𒋄	sux
mizeg	|ŠID×A|	𒋄	sux
mizem	|ŠID×A|	𒋄	sux
pisag3	|ŠID×A|	𒋄	sux
pisaj3	|ŠID×A|	𒋄	sux
pisan3	|ŠID×A|	𒋄	sux
ubisag2	|ŠID×A|	𒋄	sux
umbisag2	|ŠID×A|	𒋄	sux
umbisaj2	|ŠID×A|	𒋄	sux
hubhub2	|ŠID×IM|	𒋅	sux
MZL362	ŠIM	𒋆	sux
LAK655	ŠIM	𒋆	sux
asila2	ŠIM	𒋆	sux
asilal2	ŠIM	𒋆	sux
asilla2	ŠIM	𒋆	sux
bappir2	ŠIM	𒋆	sux
bappira2	ŠIM	𒋆	sux
lumgi	ŠIM	𒋆	sux
lunga	ŠIM	𒋆	sux
mud5	ŠIM	𒋆	sux
mulugx	ŠIM	𒋆	sux
ningi	ŠIM	𒋆	sux
nugx	ŠIM	𒋆	sux
nungi	ŠIM	𒋆	sux
reg	ŠIM	𒋆	sux
rek	ŠIM	𒋆	sux
req	ŠIM	𒋆	sux
rig	ŠIM	𒋆	sux
rik	ŠIM	𒋆	sux
riq	ŠIM	𒋆	sux
sem	ŠIM	𒋆	sux
sim	ŠIM	𒋆	sux
sirac	ŠIM	𒋆	sux
siris	ŠIM	𒋆	sux
siric	ŠIM	𒋆	sux
su20	ŠIM	𒋆	sux
cem	ŠIM	𒋆	sux
cembi2	ŠIM	𒋆	sux
cembizi	ŠIM	𒋆	sux
cembizid	ŠIM	𒋆	sux
cembulugx	ŠIM	𒋆	sux
ci6	ŠIM	𒋆	sux
cim	ŠIM	𒋆	sux
cimbi2	ŠIM	𒋆	sux
cimbizi	ŠIM	𒋆	sux
ligidba2	|ŠIM.AN.MAŠ|	𒋆𒀭𒈦	sux
ligidba	|ŠIM.AN.SAL.TUG₂.IB|	𒋆𒀭𒊩𒌆𒅁	sux
cembulugx	|ŠIM.BAL|	𒋆𒁄	sux
dumgal	|ŠIM×A|	𒋇	sux
lumgi2	|ŠIM×A|	𒋇	sux
lunga2	|ŠIM×A|	𒋇	sux
ningi2	|ŠIM×A|	𒋇	sux
nungi2	|ŠIM×A|	𒋇	sux
sirac2	|ŠIM×A|	𒋇	sux
siris2	|ŠIM×A|	𒋇	sux
cembulug4	|ŠIM×BAL|	𒋈	sux
cimbulug4	|ŠIM×BAL|	𒋈	sux
cembulug5	|ŠIM×BULUG|	𒋉	sux
cemmug	|ŠIM×BULUG|	𒋉	sux
cimbulug5	|ŠIM×BULUG|	𒋉	sux
cimmug	|ŠIM×BULUG|	𒋉	sux
nug2	|ŠIM×DIN|	𒋊	sux
LAK659	|ŠIM×GAR|	𒋋	sux
bappir	|ŠIM×GAR|	𒋋	sux
bappira	|ŠIM×GAR|	𒋋	sux
birx	|ŠIM×GAR|	𒋋	sux
lumgi3	|ŠIM×GAR|	𒋋	sux
lunga3	|ŠIM×GAR|	𒋋	sux
ningi3	|ŠIM×GAR|	𒋋	sux
nungi3	|ŠIM×GAR|	𒋋	sux
sirac3	|ŠIM×GAR|	𒋋	sux
siris3	|ŠIM×GAR|	𒋋	sux
cinx	|ŠIM×GAR|	𒋋	sux
cembulug3	|ŠIM×IGI|	𒋌	sux
cimbulug3	|ŠIM×IGI|	𒋌	sux
LAK658	|ŠIM×KUŠU₂|	𒋎	sux
cembulugx	|ŠIM×KUŠU₂|	𒋎	sux
caqa2	|ŠIM×LUL|	𒋏	sux
caqu2	|ŠIM×LUL|	𒋏	sux
cuqux	|ŠIM×LUL|	𒋏	sux
nug	|ŠIM×MUG|	𒋐	sux
cimbulug2	|ŠIM×MUG|	𒋐	sux
cemecal	|ŠIM×SAL|	𒋑	sux
cemmicla	|ŠIM×SAL|	𒋑	sux
cemcala	|ŠIM×SAL|	𒋑	sux
cimecal	|ŠIM×SAL|	𒋑	sux
cimeccal	|ŠIM×SAL|	𒋑	sux
cimmecla	|ŠIM×SAL|	𒋑	sux
LAK656	|ŠIM×IGI@g|	𒋍	sux
cembi	|ŠIM×IGI@g|	𒋍	sux
cimbi	|ŠIM×IGI@g|	𒋍	sux
cinig	ŠINIG	𒋒	sux
LAK23	ŠIR	𒋓	sux
MZL115a	ŠIR	𒋓	sux
as5	ŠIR	𒋓	sux
ac7	ŠIR	𒋓	sux
gasax	ŠIR	𒋓	sux
sil8	ŠIR	𒋓	sux
sir4	ŠIR	𒋓	sux
siru	ŠIR	𒋓	sux
sirum	ŠIR	𒋓	sux
cer	ŠIR	𒋓	sux
cir	ŠIR	𒋓	sux
cur3	ŠIR	𒋓	sux
ac7-gi4	|ŠIR.GI₄|	𒋓𒄄	sux
acgi	|ŠIR.GI₄|	𒋓𒄄	sux
LAK503	ŠITA	𒋖	sux
ecda3	ŠITA	𒋖	sux
lidda	ŠITA	𒋖	sux
mex	ŠITA	𒋖	sux
nux	ŠITA	𒋖	sux
cita	ŠITA	𒋖	sux
ecda2	|ŠITA.GIŠ.TUG₂|	𒋖𒄑𒌆	sux
ectax	|ŠITA.GIŠ.TUG₂|	𒋖𒄑𒌆	sux
i9	|ŠITA.GIŠ.TUG₂|	𒋖𒄑𒌆	sux
ecda	ŠITA₂	𒂷𒄑	sux
gicha	ŠITA₂	𒂷𒄑	sux
ha8	ŠITA₂	𒂷𒄑	sux
liddax	ŠITA₂	𒂷𒄑	sux
rig3	ŠITA₂	𒂷𒄑	sux
cita2	ŠITA₂	𒂷𒄑	sux
udub2	ŠITA₂	𒂷𒄑	sux
udug2	ŠITA₂	𒂷𒄑	sux
utug2	ŠITA₂	𒂷𒄑	sux
LAK146	ŠU	𒋗	sux
kat7	ŠU	𒋗	sux
qad	ŠU	𒋗	sux
qat	ŠU	𒋗	sux
qata	ŠU	𒋗	sux
sagix	ŠU	𒋗	sux
cu	ŠU	𒋗	sux
1(cu)	ŠU	𒋗	sux
1(cu@c)	ŠU	𒋗	sux
giri20	|ŠU.AN|	𒋗𒀭	sux
udu2	|ŠU.BAD|	𒋗𒁁	sux
uc16	|ŠU.BAD|	𒋗𒁁	sux
zapah	|ŠU.BAD|	𒋗𒁁	sux
zipah2	|ŠU.BAD|	𒋗𒁁	sux
dubul	|ŠU.BU|	𒋗𒁍	sux
dulu	|ŠU.BU|	𒋗𒁍	sux
ul7	|ŠU.BU|	𒋗𒁍	sux
sahab2	|ŠU.DI.U.U.U|	𒋗𒁲𒌋𒌋𒌋	sux
suhub4	|ŠU.DI.U.U.U|	𒋗𒁲𒌋𒌋𒌋	sux
cahab2	|ŠU.DI.U.U.U|	𒋗𒁲𒌋𒌋𒌋	sux
cuhub4	|ŠU.DI.U.U.U|	𒋗𒁲𒌋𒌋𒌋	sux
girah	|ŠU.DIM₂|	𒋗𒁶	sux
sahab	|ŠU.DIŠ|	𒋗𒁹	sux
suhub3	|ŠU.DIŠ|	𒋗𒁹	sux
cahab	|ŠU.DIŠ|	𒋗𒁹	sux
curmenx	|ŠU.EREN.ME|	𒋗𒂞𒈨	sux
suhub5	|ŠU.GA|	𒋗𒂵	sux
pec8	|ŠU.GAN|	𒋗𒃶	sux
durunx	|ŠU.GAN₂@t|	𒋗𒃸	sux
cukra	|ŠU.GAN₂@t|	𒋗𒃸	sux
cunigin	|ŠU.GAN₂@t|	𒋗𒃸	sux
tukum	|ŠU.GAR.TUR.LAL|	𒋗𒃻𒌉𒇲	sux
tukun	|ŠU.GAR.TUR.LAL|	𒋗𒃻𒌉𒇲	sux
tukumx~a	|ŠU.GAR|	𒋗𒃻	sux
tukumx~b	|ŠU.TUR|	𒋗𒌉	sux
tukumbi	|ŠU.GAR.TUR.LAL.BI|	𒋗𒃻𒌉𒇲𒁉	sux
tukunbi	|ŠU.GAR.TUR.LAL.BI|	𒋗𒃻𒌉𒇲𒁉	sux
tukumbix~a	|ŠU.LAL.TUR|	𒋗𒇲𒌉	sux
cu-gi	|ŠU.GI|	𒋗𒄀	sux
cugi	|ŠU.GI%GI|	𒋗𒄃	sux
cukudx	|ŠU.HA|	𒋗𒄩	sux
pec14	|ŠU.KAD₄|	𒋗𒆒	sux
liri	|ŠU.KAL|	𒋗𒆗	sux
liru	|ŠU.KAL|	𒋗𒆗	sux
lirum	|ŠU.KAL|	𒋗𒆗	sux
cugbar	|ŠU.KAL|	𒋗𒆗	sux
cugmac	|ŠU.KAL|	𒋗𒆗	sux
cukbar	|ŠU.KAL|	𒋗𒆗	sux
tinurx	|ŠU.LAGAB|	𒋗𒆸	sux
delen2	|ŠU.LAGAB.NA|	𒋗𒆸𒈾	sux
delena2	|ŠU.LAGAB.NA|	𒋗𒆸𒈾	sux
dilim4	|ŠU.LAGAB.NA|	𒋗𒆸𒈾	sux
dilin2	|ŠU.LAGAB.NA|	𒋗𒆸𒈾	sux
dilina2	|ŠU.LAGAB.NA|	𒋗𒆸𒈾	sux
durun3	|ŠU.LAGAB.NA|	𒋗𒆸𒈾	sux
duruna3	|ŠU.LAGAB.NA|	𒋗𒆸𒈾	sux
tinur2	|ŠU.LAGAB.NA|	𒋗𒆸𒈾	sux
giri19	|ŠU.LU₂|	𒋗𒇽	sux
giri21	|ŠU.LUGAL|	𒋗𒈗	sux
suslug	|ŠU.LUL|	𒋗𒈜	sux
curmen	|ŠU.ME.EREN|	𒋗𒈨𒂞	sux
curmin	|ŠU.ME.EREN|	𒋗𒈨𒂞	sux
qa4	|ŠU.MIN|	𒋗𒈫	sux
qad2	|ŠU.MIN|	𒋗𒈫	sux
qat2	|ŠU.MIN|	𒋗𒈫	sux
qati	|ŠU.MIN.ME.U.U.U|	𒋗𒈫𒈨𒌋𒌋𒌋	sux
tu5	|ŠU.NAGA|	𒋗𒉀	sux
gecbu2	|ŠU.PAP.PAP|	𒋗𒉽𒉽	sux
jecbu2	|ŠU.PAP.PAP|	𒋗𒉽𒉽	sux
gecpu2	|ŠU.PAP.PAP|	𒋗𒉽𒉽	sux
jecpu2	|ŠU.PAP.PAP|	𒋗𒉽𒉽	sux
jecbax	|ŠU.PAP.PAP|	𒋗𒉽𒉽	sux
sahabx	|ŠU.SI.DI|	𒋗𒋛𒁲	sux
cu-u	|ŠU.U|	𒋗𒌋	sux
LAK94	|ŠU&ŠU@180|	𒋘	sux
lilx	|ŠU&ŠU@180|	𒋘	sux
LAK385	ŠU₂	𒋙	sux
ecca2	ŠU₂	𒋙	sux
gala6	ŠU₂	𒋙	sux
cu2	ŠU₂	𒋙	sux
cubartin	ŠU₂	𒋙	sux
cuc2	ŠU₂	𒋙	sux
LAK356	|ŠU₂.AN|	𒋙𒀭	sux
MZL870	|ŠU₂.AN|	𒋙𒀭	sux
en2	|ŠU₂.AN|	𒋙𒀭	sux
gibil7	|ŠU₂.AN|	𒋙𒀭	sux
gibir2	|ŠU₂.AN|	𒋙𒀭	sux
ici2	|ŠU₂.AN|	𒋙𒀭	sux
kibir3	|ŠU₂.AN|	𒋙𒀭	sux
kunga2	|ŠU₂.AN|	𒋙𒀭	sux
kungi2	|ŠU₂.AN|	𒋙𒀭	sux
sulgar	|ŠU₂.AN|	𒋙𒀭	sux
suhul	|ŠU₂.AN|	𒋙𒀭	sux
ce9	|ŠU₂.AN|	𒋙𒀭	sux
cuhub	|ŠU₂.AN|	𒋙𒀭	sux
MZL872	|ŠU₂.3×AN|	𒋙𒀯	sux
ici2	|ŠU₂.3×AN|	𒋙𒀯	sux
kunga	|ŠU₂.3×AN|	𒋙𒀯	sux
kungi	|ŠU₂.3×AN|	𒋙𒀯	sux
suhub	|ŠU₂.3×AN|	𒋙𒀯	sux
suhul	|ŠU₂.3×AN|	𒋙𒀯	sux
sulgar	|ŠU₂.3×AN|	𒋙𒀯	sux
cuhub	|ŠU₂.3×AN|	𒋙𒀯	sux
kungax~a	|BAR.3×AN|	𒁇𒀮𒀭	sux
suhub~a	|BAR.3×AN|	𒁇𒀮𒀭	sux
cuhub~a	|BAR.3×AN|	𒁇𒀮𒀭	sux
suhub~b	|3×AN.BAR|	𒀯𒁇	sux
cuhub~b	|3×AN.BAR|	𒀯𒁇	sux
MZL247~c	|3×AN|	𒀯	sux
LAK10~c	|3×AN|	𒀯	sux
suhub2~c	|3×AN|	𒀯	sux
cuhub2~c	|3×AN|	𒀯	sux
LAK357	|ŠU₂.AN.HI×GAD|	𒋙𒀭𒄲	sux
kec3	|ŠU₂.AN.HI×GAD|	𒋙𒀭𒄲	sux
keci3	|ŠU₂.AN.HI×GAD|	𒋙𒀭𒄲	sux
kici3	|ŠU₂.AN.HI×GAD|	𒋙𒀭𒄲	sux
gibil2	|ŠU₂.AŠ₂|	𒋙𒀾	sux
gibir	|ŠU₂.AŠ₂|	𒋙𒀾	sux
kibir2	|ŠU₂.AŠ₂|	𒋙𒀾	sux
zipahx	|ŠU₂.BAD|	𒋙𒁁	sux
cudul	|ŠU₂.DUN₃@g@g@s|	𒋙	sux
cudulu	|ŠU₂.DUN₃@g@g@s|	𒋙	sux
cudun	|ŠU₂.DUN₃@g@g@s|	𒋙	sux
cutul	|ŠU₂.DUN₃@g@g@s|	𒋙	sux
kici14	|ŠU₂.NAGA|	𒋙𒉀	sux
sa17	|ŠU₂.NAGA|	𒋙𒉀	sux
sigax	|ŠU₂.NAGA|	𒋙𒉀	sux
ceg8	|ŠU₂.NAGA|	𒋙𒉀	sux
lal6	|ŠU₂.NE|	𒋙𒉈	sux
lil5	|ŠU₂.NE|	𒋙𒉈	sux
ne4	|ŠU₂.NE|	𒋙𒉈	sux
lal5	|ŠU₂.U.U.U|	𒋙𒌋𒌋𒌋	sux
lil3	|ŠU₂.U.U.U|	𒋙𒌋𒌋𒌋	sux
cudul3	|ŠU₂.UR@s|	𒋙𒌪	sux
cudun3	|ŠU₂.UR@s|	𒋙𒌪	sux
cutul3	|ŠU₂.UR@s|	𒋙𒌪	sux
LAK39	ŠUBUR	𒋚	sux
MZL22	ŠUBUR	𒋚	sux
sah2	ŠUBUR	𒋚	sux
sih	ŠUBUR	𒋚	sux
subar	ŠUBUR	𒋚	sux
subir	ŠUBUR	𒋚	sux
subur	ŠUBUR	𒋚	sux
cah	ŠUBUR	𒋚	sux
caha	ŠUBUR	𒋚	sux
ceh	ŠUBUR	𒋚	sux
cih	ŠUBUR	𒋚	sux
cubar	ŠUBUR	𒋚	sux
cubur	ŠUBUR	𒋚	sux
cubura	ŠUBUR	𒋚	sux
cuh2	ŠUBUR	𒋚	sux
s,eh	ŠUBUR	𒋚	sux
zeh2	ŠUBUR	𒋚	sux
zih2	ŠUBUR	𒋚	sux
cudax	ŠUŠANA	𒑚	sux
cucana	ŠUŠANA	𒑚	sux
cuccanx	ŠUŠANA	𒑚	sux
1/3(dic)	ŠUŠANA	𒑚	sux
1/3(dic@c)	ŠUŠANA	𒑚	sux
LAK559	TA	𒋫	sux
da2	TA	𒋫	sux
ta	TA	𒋫	sux
ta2	TA	𒋫	sux
LAK587	|TA×HI|	𒋭	sux
alammuc	|TA×HI|	𒋭	sux
alamuc	|TA×HI|	𒋭	sux
lal3	|TA×HI|	𒋭	sux
ru8	|TA×HI|	𒋭	sux
gansisx	|TA×MI|	𒋮	sux
LAK654	TA@g	𒋯	sux
gansis	TA@g	𒋯	sux
ganzerx	TA@g	𒋯	sux
kabta	TA@g	𒋯	sux
LAK90	TAB	𒋰	sux
dab2	TAB	𒋰	sux
dap2	TAB	𒋰	sux
dapa2	TAB	𒋰	sux
min6	TAB	𒋰	sux
tab	TAB	𒋰	sux
taba	TAB	𒋰	sux
tap	TAB	𒋰	sux
tapa	TAB	𒋰	sux
tab	TAB	𒋰	sux
tap	TAB	𒋰	sux
ec21	|TAB.AŠ|	𒋰𒀸	sux
megida2	|TAB.KUN|	𒋰𒆲	sux
megidda2	|TAB.KUN|	𒋰𒆲	sux
ia7	|TAB.TAB.AŠ|	𒋰𒋰𒀸	sux
ac4	|TAB.TAB.TAB|	𒋰𒋰𒋰	sux
imin2	|TAB.TAB.TAB.AŠ|	𒋰𒋰𒋰𒀸	sux
imina2	|TAB.TAB.TAB.AŠ|	𒋰𒋰𒋰𒀸	sux
umun8	|TAB.TAB.TAB.AŠ|	𒋰𒋰𒋰𒀸	sux
ussa2	|TAB.TAB.TAB.TAB|	𒋰𒋰𒋰𒋰	sux
ussu2	|TAB.TAB.TAB.TAB|	𒋰𒋰𒋰𒋰	sux
ilimmu2	|TAB.TAB.TAB.TAB.AŠ|	𒋰𒋰𒋰𒋰𒀸	sux
megida	|TAB.TI|	𒋰𒋾	sux
megidda	|TAB.TI|	𒋰𒋾	sux
burx	|4×TAB|	𒋲	sux
burux	|4×TAB|	𒋲	sux
gurinx	|4×TAB|	𒋲	sux
gurunx	|4×TAB|	𒋲	sux
kurunx	|4×TAB|	𒋲	sux
ubinigga	|TAB&TAB.NI&NI.DIŠ&DIŠ|	𒋱	sux
ubicaga	|TAB&TAB.NI&NI.DIŠ&DIŠ|	𒋱	sux
MZL221	TAG	𒋳	sux
LAK628	TAG	𒋳	sux
da6	TAG	𒋳	sux
daq6	TAG	𒋳	sux
guruc4	TAG	𒋳	sux
sux	TAG	𒋳	sux
sub6	TAG	𒋳	sux
subu	TAG	𒋳	sux
suhx	TAG	𒋳	sux
sum6	TAG	𒋳	sux
śum	TAG	𒋳	sux
can2	TAG	𒋳	sux
cerid	TAG	𒋳	sux
cerim	TAG	𒋳	sux
cu14	TAG	𒋳	sux
cum	TAG	𒋳	sux
cumu3	TAG	𒋳	sux
cuc4	TAG	𒋳	sux
ta3	TAG	𒋳	sux
tag	TAG	𒋳	sux
taga	TAG	𒋳	sux
tak	TAG	𒋳	sux
taka	TAG	𒋳	sux
taq	TAG	𒋳	sux
tibir	TAG	𒋳	sux
tuku5	TAG	𒋳	sux
uttux	TAG	𒋳	sux
zil2	TAG	𒋳	sux
cumgamme	|TAG.GAM.ME|	𒋳𒃵𒈨	sux
ziz5	|TAG.TAG|	𒋳𒋳	sux
cerax	|TAG.TUG₂|	𒋳𒌆	sux
cerimx	|TAG.TUG₂|	𒋳𒌆	sux
silig4	|TAG×GUD|	𒋵	sux
tibir5	|TAG×GUD|	𒋵	sux
tibirx	|TAG×ŠE|	𒋶	sux
tibir2	|TAG×ŠU|	𒋷	sux
silig3	|TAG×TUG₂|	𒋸	sux
tibir4	|TAG×TUG₂|	𒋸	sux
utu	|TAG×TUG₂|	𒋸	sux
utux	|TAG×TUG₂|	𒋸	sux
uttu	|TAG×TUG₂|	𒋸	sux
silig2	|TAG×UD|	𒋹	sux
tibir3	|TAG×UD|	𒋹	sux
MZL106	TAK₄	𒋺	sux
LAK282	TAK₄	𒋺	sux
azad2	TAK₄	𒋺	sux
da13	TAK₄	𒋺	sux
dad	TAK₄	𒋺	sux
dat	TAK₄	𒋺	sux
erbura	TAK₄	𒋺	sux
gid6	TAK₄	𒋺	sux
gudx	TAK₄	𒋺	sux
gudibir	TAK₄	𒋺	sux
irbura	TAK₄	𒋺	sux
kamx	TAK₄	𒋺	sux
kid2	TAK₄	𒋺	sux
kit2	TAK₄	𒋺	sux
cux	TAK₄	𒋺	sux
curu6	TAK₄	𒋺	sux
curum6	TAK₄	𒋺	sux
ta6	TAK₄	𒋺	sux
tad	TAK₄	𒋺	sux
tag4	TAK₄	𒋺	sux
tak4	TAK₄	𒋺	sux
taka4	TAK₄	𒋺	sux
tat	TAK₄	𒋺	sux
tukx	TAK₄	𒋺	sux
tat	TAK₄	𒋺	sux
urx	TAK₄	𒋺	sux
zermuckux	|TAK₄.ALAN|	𒋺𒀩	sux
dadda	|TAK₄.TAK₄|	𒋺𒋺	sux
tatge	|TAK₄.TAK₄|	𒋺𒋺	sux
LAK181	TAR	𒋻	sux
MZL9	TAR	𒋻	sux
dar6	TAR	𒋻	sux
gud4	TAR	𒋻	sux
has	TAR	𒋻	sux
hac	TAR	𒋻	sux
has,	TAR	𒋻	sux
haz	TAR	𒋻	sux
hiz	TAR	𒋻	sux
hus2	TAR	𒋻	sux
ku5	TAR	𒋻	sux
kud	TAR	𒋻	sux
kudma	TAR	𒋻	sux
kuksu	TAR	𒋻	sux
kur5	TAR	𒋻	sux
kuru5	TAR	𒋻	sux
kurum5	TAR	𒋻	sux
kut	TAR	𒋻	sux
kutu	TAR	𒋻	sux
qadmax	TAR	𒋻	sux
qadmu	TAR	𒋻	sux
qud	TAR	𒋻	sux
qudma	TAR	𒋻	sux
qudmu	TAR	𒋻	sux
qumx	TAR	𒋻	sux
qut	TAR	𒋻	sux
qutu	TAR	𒋻	sux
sel	TAR	𒋻	sux
six	TAR	𒋻	sux
sil	TAR	𒋻	sux
sila	TAR	𒋻	sux
sulu	TAR	𒋻	sux
car7	TAR	𒋻	sux
cel	TAR	𒋻	sux
cil	TAR	𒋻	sux
tax	TAR	𒋻	sux
tar	TAR	𒋻	sux
tara	TAR	𒋻	sux
ter2	TAR	𒋻	sux
tir2	TAR	𒋻	sux
tar	TAR	𒋻	sux
tir2	TAR	𒋻	sux
ursagsim	TAR	𒋻	sux
ursajsim	TAR	𒋻	sux
zil0	TAR	𒋻	sux
zil3	TAR	𒋻	sux
LAK373	TE	𒋼	sux
de4	TE	𒋼	sux
di12	TE	𒋼	sux
gal5	TE	𒋼	sux
gallax	TE	𒋼	sux
gul3	TE	𒋼	sux
mul2	TE	𒋼	sux
te	TE	𒋼	sux
teg3	TE	𒋼	sux
tej3	TE	𒋼	sux
temx	TE	𒋼	sux
temen	TE	𒋼	sux
temennax	TE	𒋼	sux
ten	TE	𒋼	sux
ti7	TE	𒋼	sux
te4	TE	𒋼	sux
ti4	TE	𒋼	sux
unux	TE	𒋼	sux
LAK375	|TE.A|	𒋼𒀀	sux
gar14	|TE.A|	𒋼𒀀	sux
ka11	|TE.A|	𒋼𒀀	sux
kar	|TE.A|	𒋼𒀀	sux
kara	|TE.A|	𒋼𒀀	sux
kir8	|TE.A|	𒋼𒀀	sux
qar2	|TE.A|	𒋼𒀀	sux
unu6	|TE.AB|	𒋼𒀊	sux
unug3	|TE.AB|	𒋼𒀊	sux
unu2	|TE.AB@g|	𒋼𒀕	sux
unug2	|TE.AB@g|	𒋼𒀕	sux
gal5-la	|TE.LAL|	𒋼𒇲	sux
galla	|TE.LAL|	𒋼𒇲	sux
galu	|TE.LAL|	𒋼𒇲	sux
gulla	|TE.LAL|	𒋼𒇲	sux
LAK374	|TE.ME|	𒋼𒈨	sux
mete	|TE.ME|	𒋼𒈨	sux
unux	|TE.MUŠ₃|	𒋼𒈹	sux
LAK382	TE@g	𒋽	sux
MZL88	TE@g	𒋽	sux
gar13	TE@g	𒋽	sux
gur8	TE@g	𒋽	sux
gura8	TE@g	𒋽	sux
guru8	TE@g	𒋽	sux
qurx	TE@g	𒋽	sux
ru10	TE@g	𒋽	sux
tex	TE@g	𒋽	sux
ur12	TE@g	𒋽	sux
uru5	TE@g	𒋽	sux
unu7	|TE@g.AB@g|	𒋽𒀕	sux
unug4	|TE@g.AB@g|	𒋽𒀕	sux
LAK18	TI	𒋾	sux
MZL118	TI	𒋾	sux
de9	TI	𒋾	sux
di3	TI	𒋾	sux
te9	TI	𒋾	sux
tej4	TI	𒋾	sux
ti	TI	𒋾	sux
tibnu	TI	𒋾	sux
tig4	TI	𒋾	sux
tij4	TI	𒋾	sux
til3	TI	𒋾	sux
tila3	TI	𒋾	sux
te6	TI	𒋾	sux
ti3	TI	𒋾	sux
MZL118	TI@t	𒋿	sux
tana	TI@t	𒋿	sux
tibnu	TI@t	𒋿	sux
MZL113b	TIL	𒌀	sux
LAK17	TIL	𒌀	sux
sumun	TIL	𒌀	sux
cum4	TIL	𒌀	sux
cumun	TIL	𒌀	sux
sun	TIL	𒌀	sux
suna	TIL	𒌀	sux
tel	TIL	𒌀	sux
til	TIL	𒌀	sux
ug7	TIL	𒌀	sux
uc2	TIL	𒌀	sux
LAK211	TU	𒌅	sux
MZL86	TU	𒌅	sux
du2	TU	𒌅	sux
dud2	TU	𒌅	sux
dur11	TU	𒌅	sux
hu2	TU	𒌅	sux
huduc	TU	𒌅	sux
namcece	TU	𒌅	sux
tu	TU	𒌅	sux
tud	TU	𒌅	sux
tum12	TU	𒌅	sux
tur5	TU	𒌅	sux
tu2	TU	𒌅	sux
aclag2	TUG₂	𒌆	sux
azalag2	TUG₂	𒌆	sux
azlag2	TUG₂	𒌆	sux
dul5	TUG₂	𒌆	sux
i6	TUG₂	𒌆	sux
mu4	TUG₂	𒌆	sux
mur10	TUG₂	𒌆	sux
taskarin	TUG₂	𒌆	sux
tackarin	TUG₂	𒌆	sux
te5	TUG₂	𒌆	sux
tickarin	TUG₂	𒌆	sux
tickarini	TUG₂	𒌆	sux
tu9	TUG₂	𒌆	sux
tubax	TUG₂	𒌆	sux
tug2	TUG₂	𒌆	sux
tuk2	TUG₂	𒌆	sux
tuku2	TUG₂	𒌆	sux
umuc	TUG₂	𒌆	sux
uc4	TUG₂	𒌆	sux
tugir	|TUG₂.DU@s|	𒌆𒁽	sux
aclag	|TUG₂.UD|	𒌆𒌓	sux
azalag	|TUG₂.UD|	𒌆𒌓	sux
azlag	|TUG₂.UD|	𒌆𒌓	sux
du12	TUK	𒌇	sux
duk2	TUK	𒌇	sux
rac2	TUK	𒌇	sux
tu12	TUK	𒌇	sux
tug	TUK	𒌇	sux
tuk	TUK	𒌇	sux
tuku	TUK	𒌇	sux
tuq	TUK	𒌇	sux
duddu	|TUK.TUK|	𒌇𒌇	sux
duttu	|TUK.TUK|	𒌇𒌇	sux
LAK494	TUM	𒌈	sux
dam3	TUM	𒌈	sux
du4	TUM	𒌈	sux
dum	TUM	𒌈	sux
eb2	TUM	𒌈	sux
eger4	TUM	𒌈	sux
egir4	TUM	𒌈	sux
ep2	TUM	𒌈	sux
geckadx	TUM	𒌈	sux
gickadx	TUM	𒌈	sux
jeckadx	TUM	𒌈	sux
jickadx	TUM	𒌈	sux
ib2	TUM	𒌈	sux
ip2	TUM	𒌈	sux
ri...	TUM	𒌈	sux
suri	TUM	𒌈	sux
tam4	TUM	𒌈	sux
tim2	TUM	𒌈	sux
tu4	TUM	𒌈	sux
tum	TUM	𒌈	sux
tu4	TUM	𒌈	sux
tum	TUM	𒌈	sux
LAK528	TUR	𒌉	sux
ban3	TUR	𒌉	sux
banda3	TUR	𒌉	sux
damu	TUR	𒌉	sux
di4	TUR	𒌉	sux
du13	TUR	𒌉	sux
dumx	TUR	𒌉	sux
dumu	TUR	𒌉	sux
ibila4	TUR	𒌉	sux
maru	TUR	𒌉	sux
pec7	TUR	𒌉	sux
suhucx	TUR	𒌉	sux
cak7	TUR	𒌉	sux
cir6	TUR	𒌉	sux
tu19	TUR	𒌉	sux
tul4	TUR	𒌉	sux
tur	TUR	𒌉	sux
tura	TUR	𒌉	sux
turu	TUR	𒌉	sux
tur3	TUR	𒌉	sux
zerx	TUR	𒌉	sux
ibila2	|TUR.ARAD|	𒌉𒀴	sux
gena	|TUR.DIŠ|	𒌉𒁹	sux
genan	|TUR.DIŠ|	𒌉𒁹	sux
genna	|TUR.DIŠ|	𒌉𒁹	sux
gina	|TUR.DIŠ|	𒌉𒁹	sux
ginan	|TUR.DIŠ|	𒌉𒁹	sux
ginna	|TUR.DIŠ|	𒌉𒁹	sux
hibis	|TUR.DIŠ|	𒌉𒁹	sux
hibiz	|TUR.DIŠ|	𒌉𒁹	sux
ibilax	|TUR.DIŠ|	𒌉𒁹	sux
dumu-gi7	|TUR.EŠ₂|	𒌉𒂠	sux
kun5	|TUR.EŠ₂|	𒌉𒂠	sux
kuj5	|TUR.EŠ₂|	𒌉𒂠	sux
murumx	|TUR.SAL.TUR.TUR|	𒌉𒊩𒌉𒌉	sux
ibila3	|TUR.SAG|	𒌉𒊕	sux
dex-dex	|TUR.TUR|	𒌉𒌉	sux
di4-di4	|TUR.TUR|	𒌉𒌉	sux
du13-du13	|TUR.TUR|	𒌉𒌉	sux
tilx	|TUR.TUR|	𒌉𒌉	sux
tur-tur	|TUR.TUR|	𒌉𒌉	sux
ibila	|TUR.UŠ|	𒌉𒍑	sux
zazana	|TUR&TUR.ZA&ZA|	𒌊	sux
zazna	|TUR&TUR.ZA&ZA|	𒌊	sux
zezna	|TUR&TUR.ZA&ZA|	𒌊	sux
zizx	|TUR&TUR.ZA&ZA|	𒌊	sux
zizna	|TUR&TUR.ZA&ZA|	𒌊	sux
LAK807	U	𒌋	sux
a6	U	𒌋	sux
barx	U	𒌋	sux
bu12	U	𒌋	sux
bur3	U	𒌋	sux
bur3@c	U	𒌋	sux
buru3	U	𒌋	sux
burudx	U	𒌋	sux
buzur	U	𒌋	sux
ge14	U	𒌋	sux
gecburx	U	𒌋	sux
gibiru	U	𒌋	sux
giburu	U	𒌋	sux
giguru	U	𒌋	sux
guru12	U	𒌋	sux
ha3	U	𒌋	sux
hu3	U	𒌋	sux
puzur	U	𒌋	sux
cil3	U	𒌋	sux
cu4	U	𒌋	sux
cuc	U	𒌋	sux
u	U	𒌋	sux
ubux	U	𒌋	sux
umun	U	𒌋	sux
un2	U	𒌋	sux
ucur5	U	𒌋	sux
utahx	U	𒌋	sux
utux	U	𒌋	sux
1(u)	U	𒌋	sux
1(u@c)	U	𒌋	sux
1(bur3)	U	𒌋	sux
1(bur3@c)	U	𒌋	sux
u@c	U	𒌋	sux
LAK414	|U.AD|	𒌋𒀜	sux
gir4	|U.AD|	𒌋𒀜	sux
isi3	|U.AD|	𒌋𒀜	sux
isim3	|U.AD|	𒌋𒀜	sux
isimu3	|U.AD|	𒌋𒀜	sux
kir13	|U.AD|	𒌋𒀜	sux
kirix	|U.AD|	𒌋𒀜	sux
acdar	|U.DAR|	𒌋𒁯	sux
muc7	|U.DAR|	𒌋𒁯	sux
u-gun3	|U.DAR|	𒌋𒁯	sux
ugun	|U.DAR|	𒌋𒁯	sux
ugunu	|U.DAR|	𒌋𒁯	sux
gakkul3	|U.DIM|	𒌋𒁴	sux
kakkul3	|U.DIM|	𒌋𒁴	sux
mun6	|U.DIM|	𒌋𒁴	sux
gakkul	|U.DIM×ŠE|	𒌋𒁵	sux
kakkul	|U.DIM×ŠE|	𒌋𒁵	sux
mun5	|U.DIM×ŠE|	𒌋𒁵	sux
bahar3	|U.EDIN|	𒌋𒂔	sux
ecgarx	|U.EN×GAN₂@t|	𒌋𒂙	sux
ecgiri	|U.EN×GAN₂@t|	𒌋𒂙	sux
eckiri	|U.EN×GAN₂@t|	𒌋𒂙	sux
ganu	|U.EN×GAN₂@t|	𒌋𒂙	sux
girx	|U.EN×GAN₂@t|	𒌋𒂙	sux
kir12	|U.EN×GAN₂@t|	𒌋𒂙	sux
kirrux	|U.EN×GAN₂@t|	𒌋𒂙	sux
sibir	|U.EN×GAN₂@t|	𒌋𒂙	sux
cibir	|U.EN×GAN₂@t|	𒌋𒂙	sux
ucbar5	|U.EN×GAN₂@t|	𒌋𒂙	sux
ucbur5	|U.EN×GAN₂@t|	𒌋𒂙	sux
LAK412	|U.GA|	𒌋𒂵	sux
dimna	|U.GA|	𒌋𒂵	sux
sagx	|U.GA|	𒌋𒂵	sux
u14	|U.GA|	𒌋𒂵	sux
ud6	|U.GA|	𒌋𒂵	sux
ulx	|U.GA|	𒌋𒂵	sux
ut6	|U.GA|	𒌋𒂵	sux
utah	|U.GA|	𒌋𒂵	sux
utu2	|U.GA|	𒌋𒂵	sux
zagx	|U.GA|	𒌋𒂵	sux
zahan2	|U.GA|	𒌋𒂵	sux
zahan	|U.GA.HI|	𒌋𒂵𒄭	sux
LAK458	|U.GAN|	𒌋𒃶	sux
saman4	|U.GAN|	𒌋𒃶	sux
cagan	|U.GAN|	𒌋𒃶	sux
cajan	|U.GAN|	𒌋𒃶	sux
cakan	|U.GAN|	𒌋𒃶	sux
caman2	|U.GAN|	𒌋𒃶	sux
LAK300	|U.GUD|	𒌌	sux
du7	|U.GUD|	𒌌	sux
mul4	|U.GUD|	𒌌	sux
rax	|U.GUD|	𒌌	sux
ru5	|U.GUD|	𒌌	sux
ul	|U.GUD|	𒌌	sux
ula	|U.GUD|	𒌌	sux
ullu	|U.GUD|	𒌌	sux
ullu3	|U.GUD|	𒌌	sux
ulu	|U.GUD|	𒌌	sux
ur6	|U.GUD|	𒌌	sux
ugur	|U.GUR|	𒌋𒄥	sux
nergalx	|U.GUR|	𒌋𒄥	sux
uia	|U.5(DIŠ)|	𒌋𒐊	sux
uya	|U.5(DIŠ)|	𒌋𒐊	sux
udilia	|U.5(DIŠ)|	𒌋𒐊	sux
LAK413	|U.KA|	𒌋𒅗	sux
ele	|U.KA|	𒌋𒅗	sux
eli	|U.KA|	𒌋𒅗	sux
mah3	|U.KA|	𒌋𒅗	sux
muh	|U.KA|	𒌋𒅗	sux
ugu	|U.KA|	𒌋𒅗	sux
ugun3	|U.KA|	𒌋𒅗	sux
niginx	|U.KID|	𒌋𒆤	sux
cagx	|U.KID|	𒌋𒆤	sux
cakx	|U.KID|	𒌋𒆤	sux
cita4	|U.KID|	𒌋𒆤	sux
cudul6	|U.KID|	𒌋𒆤	sux
cutul6	|U.KID|	𒌋𒆤	sux
gira	|U.MAŠ.KAB|	𒌋𒈦𒆏	sux
udul8	|U.MU|	𒌋𒈬	sux
udun	|U.MU|	𒌋𒈬	sux
umun10	|U.MU|	𒌋𒈬	sux
utul8	|U.MU|	𒌋𒈬	sux
utun	|U.MU|	𒌋𒈬	sux
kici10	|U.PIRIG|	𒌋𒊊	sux
kuc5	|U.PIRIG|	𒌋𒊊	sux
kucu	|U.PIRIG|	𒌋𒊊	sux
kucum4	|U.PIRIG|	𒌋𒊊	sux
LAK316	|U.SAG|	𒌋𒊕	sux
sagdul	|U.SAG|	𒌋𒊕	sux
sagcu	|U.SAG|	𒌋𒊕	sux
sagtucx	|U.SAG|	𒌋𒊕	sux
sajcu	|U.SAG|	𒌋𒊕	sux
ugux	|U.SAG|	𒌋𒊕	sux
baharx	|U.SAR|	𒌋𒊬	sux
bakiru	|U.SAR|	𒌋𒊬	sux
bakirum	|U.SAR|	𒌋𒊬	sux
mahar2	|U.SAR|	𒌋𒊬	sux
LAK411	|U.ŠA|	𒌋𒊭	sux
KWU509	|U.ŠA|	𒌋𒊭	sux
sagx	|U.ŠA|	𒌋𒊭	sux
urum7	|U.ŠA|	𒌋𒊭	sux
usagx	|U.ŠA|	𒌋𒊭	sux
zax	|U.ŠA|	𒌋𒊭	sux
dul	|U.TUG₂|	𒌋𒌆	sux
cudul2	|U.TUG₂|	𒌋𒌆	sux
cudun2	|U.TUG₂|	𒌋𒌆	sux
cutul2	|U.TUG₂|	𒌋𒌆	sux
tul	|U.TUG₂|	𒌋𒌆	sux
amna2	|U.U|	𒌋𒌋	sux
buzur2	|U.U|	𒌋𒌋	sux
gecx	|U.U|	𒌋𒌋	sux
gicx	|U.U|	𒌋𒌋	sux
mam	|U.U|	𒌋𒌋	sux
man	|U.U|	𒌋𒌋	sux
mana	|U.U|	𒌋𒌋	sux
men5	|U.U|	𒌋𒌋	sux
mecx	|U.U|	𒌋𒌋	sux
mim3	|U.U|	𒌋𒌋	sux
min3	|U.U|	𒌋𒌋	sux
mina3	|U.U|	𒌋𒌋	sux
nac	|U.U|	𒌋𒌋	sux
nes	|U.U|	𒌋𒌋	sux
nec	|U.U|	𒌋𒌋	sux
nis	|U.U|	𒌋𒌋	sux
nic	|U.U|	𒌋𒌋	sux
niz	|U.U|	𒌋𒌋	sux
puzur2	|U.U|	𒌋𒌋	sux
camac2	|U.U|	𒌋𒌋	sux
car4	|U.U|	𒌋𒌋	sux
carru2	|U.U|	𒌋𒌋	sux
cucana2	|U.U|	𒌋𒌋	sux
cucanaku	|U.U|	𒌋𒌋	sux
tab4	|U.U|	𒌋𒌋	sux
utu3	|U.U|	𒌋𒌋	sux
wan	|U.U|	𒌋𒌋	sux
2(u)	|U.U|	𒌋𒌋	sux
2(u@c)	|U.U|	𒌋𒌋	sux
2(bur3)	|U.U|	𒌋𒌋	sux
2(bur3@c)	|U.U|	𒌋𒌋	sux
ba3	|U.U.U|	𒌍	sux
batu	|U.U.U|	𒌍	sux
es2	|U.U.U|	𒌍	sux
ec	|U.U.U|	𒌍	sux
eca2	|U.U.U|	𒌍	sux
ece	|U.U.U|	𒌍	sux
is5	|U.U.U|	𒌍	sux
ic3	|U.U.U|	𒌍	sux
nan3	|U.U.U|	𒌍	sux
sin	|U.U.U|	𒌍	sux
s,in	|U.U.U|	𒌍	sux
cib0	|U.U.U|	𒌍	sux
cip0	|U.U.U|	𒌍	sux
uc18	|U.U.U|	𒌍	sux
ucu3	|U.U.U|	𒌍	sux
3(u)	|U.U.U|	𒌍	sux
3(u@c)	|U.U.U|	𒌍	sux
3(bur3)	|U.U.U|	𒌍	sux
3(bur3@c)	|U.U.U|	𒌍	sux
bangacx	|U.U.U.AŠ₃|	𒌋𒌋𒌋𒐋	sux
nigin4	|U.UD|	𒌋𒌓	sux
nim3	|U.UD|	𒌋𒌓	sux
ningin4	|U.UD|	𒌋𒌓	sux
cu16	|U.UD|	𒌋𒌓	sux
ucu2	|U.UD|	𒌋𒌓	sux
uzu5	|U.UD|	𒌋𒌓	sux
LAK402	|U.UD.KID|	𒌋𒌓𒆤	sux
ni9	|U.UD.KID|	𒌋𒌓𒆤	sux
nig6	|U.UD.KID|	𒌋𒌓𒆤	sux
nigar	|U.UD.KID|	𒌋𒌓𒆤	sux
nigin3	|U.UD.KID|	𒌋𒌓𒆤	sux
nij6	|U.UD.KID|	𒌋𒌓𒆤	sux
nijar	|U.UD.KID|	𒌋𒌓𒆤	sux
nijin3	|U.UD.KID|	𒌋𒌓𒆤	sux
nimgin3	|U.UD.KID|	𒌋𒌓𒆤	sux
ningin3	|U.UD.KID|	𒌋𒌓𒆤	sux
cutulx	|U.UR@s|	𒌋𒌪	sux
buzur3	|U.ZAG|	𒌋𒍠	sux
puzur3	|U.ZAG|	𒌋𒍠	sux
garadin10	|U&U.PA&PA.GAR&GAR|	𒌎	sux
karadin10	|U&U.PA&PA.GAR&GAR|	𒌎	sux
garadin9	|U&U.SUR&SUR|	𒌏	sux
karadin9	|U&U.SUR&SUR|	𒌏	sux
illil2	|U&U.U&U.U|	𒐐	sux
kingusili2	|U&U.U&U.U|	𒐐	sux
ninnix	|U&U.U&U.U|	𒐐	sux
ninnu	|U&U.U&U.U|	𒐐	sux
ninux	|U&U.U&U.U|	𒐐	sux
bargi	|U&U.U@v&U@v|	𒌐	sux
macgi	|U&U.U@v&U@v|	𒌐	sux
LAK152	U₂	𒌑	sux
ba6	U₂	𒌑	sux
bu11	U₂	𒌑	sux
hazabur	U₂	𒌑	sux
kazab	U₂	𒌑	sux
kazabu	U₂	𒌑	sux
kazabur	U₂	𒌑	sux
kazbi	U₂	𒌑	sux
kazbu	U₂	𒌑	sux
kilibu	U₂	𒌑	sux
kecx	U₂	𒌑	sux
kuc3	U₂	𒌑	sux
kucumx	U₂	𒌑	sux
kuzbi	U₂	𒌑	sux
kuzbu	U₂	𒌑	sux
macammi	U₂	𒌑	sux
maccam	U₂	𒌑	sux
mat cammi	U₂	𒌑	sux
pu11	U₂	𒌑	sux
sam	U₂	𒌑	sux
cam	U₂	𒌑	sux
tecbi	U₂	𒌑	sux
u2	U₂	𒌑	sux
ugax	U₂	𒌑	sux
wa3	U₂	𒌑	sux
wux	U₂	𒌑	sux
azad	|A.LAGAB×KUL.MA₂.ŠU₂.A|	𒀀𒇒𒈣𒋙𒀀	sux
ad5	|U₂.GIR₂@g|	𒌑𒄉	sux
adda3	|U₂.GIR₂@g|	𒌑𒄉	sux
addu2	|U₂.GIR₂@g|	𒌑𒄉	sux
atu	|U₂.GIR₂@g|	𒌑𒄉	sux
kic16	|U₂.GIR₂@g|	𒌑𒄉	sux
kica	|U₂.GIR₂@g|	𒌑𒄉	sux
kiceg	|U₂.GIR₂@g|	𒌑𒄉	sux
kicek	|U₂.GIR₂@g|	𒌑𒄉	sux
kici16	|U₂.GIR₂@g|	𒌑𒄉	sux
kicig	|U₂.GIR₂@g|	𒌑𒄉	sux
kicik	|U₂.GIR₂@g|	𒌑𒄉	sux
dimuc	|U₂.GIŠ.MI|	𒌑𒄑𒈪	sux
dimmuc	|U₂.GIŠ.MI|	𒌑𒄑𒈪	sux
muthum	|U₂.GIŠ.SAR|	𒌑𒄑𒊬	sux
musug2	|U₂.KA|	𒌑𒅗	sux
muzug2	|U₂.KA|	𒌑𒅗	sux
usug2	|U₂.KA|	𒌑𒅗	sux
uzug2	|U₂.KA|	𒌑𒅗	sux
gud3	|U₂.KI.SUM.GA|	𒌑𒆠𒋧𒂵	sux
musug4	|U₂.KUR.NI.TUK.KI|	𒌑𒆳𒉌𒌇𒆠	sux
muzug4	|U₂.KUR.NI.TUK.KI|	𒌑𒆳𒉌𒌇𒆠	sux
usug4	|U₂.KUR.NI.TUK.KI|	𒌑𒆳𒉌𒌇𒆠	sux
uzug4	|U₂.KUR.NI.TUK.KI|	𒌑𒆳𒉌𒌇𒆠	sux
cembirida	|U₂.KUR.RA|	𒌑𒆳𒊏	sux
cimbirida	|U₂.KUR.RA|	𒌑𒆳𒊏	sux
namru	|U₂.KUR.ZA.MUŠ₃@g.KI|	𒌑𒆳𒍝𒈽𒆠	sux
namri	|U₂.KUR.ZA.MUŠ₃@g.KI|	𒌑𒆳𒍝𒈽𒆠	sux
uga	|U₂.NAGA.GA|	𒌑𒉀𒂵	sux
ugax~a	|U₂.NAGA|	𒌑𒉀	sux
didax	|U₂.SA|	𒌑𒊓	sux
pihux	|U₂.SA|	𒌑𒊓	sux
pihux	|U₂.SA.KA.KAK|	𒌑𒊓𒅗𒆕	sux
muzug	|U₂.SAG|	𒌑𒊕	sux
uzug3	|U₂.SAG|	𒌑𒊕	sux
cubax	|U₂.ZA.MUŠ₃|	𒌑𒍝𒈹	sux
cubux	|U₂.ZA.MUŠ₃|	𒌑𒍝𒈹	sux
LAK284	UB	𒌒	sux
ar2	UB	𒌒	sux
ara2	UB	𒌒	sux
ub	UB	𒌒	sux
uba	UB	𒌒	sux
ubda	UB	𒌒	sux
ubu2	UB	𒌒	sux
up	UB	𒌒	sux
warx	UB	𒌒	sux
ummax	|UB.ME|	𒌒𒈨	sux
zamin	|UB.RI|	𒌒𒊑	sux
LAK400	UD	𒌓	sux
a12	UD	𒌓	sux
ah3	UD	𒌓	sux
wās,it	UD	𒌓	sux
mās,it	UD	𒌓	sux
s,ītu	UD	𒌓	sux
al5	UD	𒌓	sux
amna	UD	𒌓	sux
ara7	UD	𒌓	sux
ayax	UD	𒌓	sux
bab2	UD	𒌓	sux
babar	UD	𒌓	sux
babbar	UD	𒌓	sux
bar6	UD	𒌓	sux
barax	UD	𒌓	sux
ber2	UD	𒌓	sux
bec12	UD	𒌓	sux
bir2	UD	𒌓	sux
da7	UD	𒌓	sux
dag2	UD	𒌓	sux
dam2	UD	𒌓	sux
e8	UD	𒌓	sux
gal8	UD	𒌓	sux
ha5	UD	𒌓	sux
had2	UD	𒌓	sux
hada2	UD	𒌓	sux
hac3	UD	𒌓	sux
hec	UD	𒌓	sux
his	UD	𒌓	sux
hic	UD	𒌓	sux
hud2	UD	𒌓	sux
kum4	UD	𒌓	sux
la7	UD	𒌓	sux
lah	UD	𒌓	sux
lih	UD	𒌓	sux
luhx	UD	𒌓	sux
par	UD	𒌓	sux
para	UD	𒌓	sux
per	UD	𒌓	sux
pec12	UD	𒌓	sux
pir	UD	𒌓	sux
pirig2	UD	𒌓	sux
pirij2	UD	𒌓	sux
ra3	UD	𒌓	sux
sa16	UD	𒌓	sux
salah	UD	𒌓	sux
siki2	UD	𒌓	sux
camac	UD	𒌓	sux
carag	UD	𒌓	sux
ta5	UD	𒌓	sux
tam	UD	𒌓	sux
tu2	UD	𒌓	sux
tam2	UD	𒌓	sux
u4	UD	𒌓	sux
ud	UD	𒌓	sux
ug4	UD	𒌓	sux
ul6	UD	𒌓	sux
um2	UD	𒌓	sux
un5	UD	𒌓	sux
ut	UD	𒌓	sux
uta	UD	𒌓	sux
utu	UD	𒌓	sux
ut	UD	𒌓	sux
zalax	UD	𒌓	sux
zalag	UD	𒌓	sux
zalaga	UD	𒌓	sux
zalah	UD	𒌓	sux
zalaqax	UD	𒌓	sux
pec9	|UD.A|	𒌓𒀀	sux
ararama2	|UD.AB|	𒌓𒀊	sux
ararma2	|UD.AB|	𒌓𒀊	sux
larsa2	|UD.AB|	𒌓𒀊	sux
larsam2	|UD.AB|	𒌓𒀊	sux
arar	|UD.AB@g|	𒌓𒀕	sux
ararama	|UD.AB@g|	𒌓𒀕	sux
ararma	|UD.AB@g|	𒌓𒀕	sux
larsa	|UD.AB@g|	𒌓𒀕	sux
larsam	|UD.AB@g|	𒌓𒀕	sux
id4	|UD.AN.ŠEŠ.KI|	𒌓𒀭𒋀𒆠	sux
it4	|UD.AN.ŠEŠ.KI|	𒌓𒀭𒋀𒆠	sux
itax	|UD.AN.ŠEŠ.KI|	𒌓𒀭𒋀𒆠	sux
iti6	|UD.AN.ŠEŠ.KI|	𒌓𒀭𒋀𒆠	sux
itudx	|UD.AN.ŠEŠ.KI|	𒌓𒀭𒋀𒆠	sux
cerrida	|UD.AN.UD|	𒌓𒀭𒌓	sux
ara4	|UD.DU|	𒌓𒁺	sux
e3	|UD.DU|	𒌓𒁺	sux
ed2	|UD.DU|	𒌓𒁺	sux
edax	|UD.DU|	𒌓𒁺	sux
i10	|UD.DU|	𒌓𒁺	sux
sagus	|UD.DU|	𒌓𒁺	sux
saguc	|UD.DU|	𒌓𒁺	sux
a12-ra2-bu	|UD.DU.BU|	𒌓𒁺𒁍	sux
gidi6	|UD.GAN|	𒌓𒃶	sux
kaz9	|UD.HI×AŠ₂|	𒌓𒄯	sux
sipar	|UD.KA.BAR|	𒌓𒅗𒁇	sux
zabar	|UD.KA.BAR|	𒌓𒅗𒁇	sux
zibar	|UD.KA.BAR|	𒌓𒅗𒁇	sux
buranun	|UD.GIŠ%GIŠ.NUN|	𒌓𒄒𒉣	sux
buranuna	|UD.GIŠ%GIŠ.NUN|	𒌓𒄒𒉣	sux
buranunu	|UD.GIŠ%GIŠ.NUN|	𒌓𒄒𒉣	sux
burunun	|UD.GIŠ%GIŠ.NUN|	𒌓𒄒𒉣	sux
burununa	|UD.GIŠ%GIŠ.NUN|	𒌓𒄒𒉣	sux
sippar	|UD.GIŠ%GIŠ.NUN|	𒌓𒄒𒉣	sux
zimbir	|UD.GIŠ%GIŠ.NUN|	𒌓𒄒𒉣	sux
niginx	|UD.KID|	𒌓𒆤	sux
LAK305	|UD.KUŠU₂|	𒌔	sux
ah6	|UD.KUŠU₂|	𒌔	sux
akcak	|UD.KUŠU₂|	𒌔	sux
garu	|UD.KUŠU₂|	𒌔	sux
huya	|UD.KUŠU₂|	𒌔	sux
kec18	|UD.KUŠU₂|	𒌔	sux
keci18	|UD.KUŠU₂|	𒌔	sux
kua2	|UD.KUŠU₂|	𒌔	sux
kuia	|UD.KUŠU₂|	𒌔	sux
kucax	|UD.KUŠU₂|	𒌔	sux
kucu3	|UD.KUŠU₂|	𒌔	sux
kuwa2	|UD.KUŠU₂|	𒌔	sux
kuya2	|UD.KUŠU₂|	𒌔	sux
u)4	|UD.KUŠU₂|	𒌔	sux
uh2	|UD.KUŠU₂|	𒌔	sux
uhu2	|UD.KUŠU₂|	𒌔	sux
sirara4	|UD.MA₂.AB×HA|	𒌓𒈣𒀏	sux
sirara6	|UD.MA₂.AB×HA.KI.TAG|	𒌓𒈣𒀏𒆠𒋳	sux
sirara2	|UD.MA₂.AB×HA.ŠIR|	𒌓𒈣𒀏𒋓	sux
sirara3	|UD.MA₂.AB×HA.TAG|	𒌓𒈣𒀏𒋳	sux
abbununna	|UD.HU.HI.NUN|	𒌓𒄷𒄭𒉣	sux
abbununnu	|UD.HU.HI.NUN|	𒌓𒄷𒄭𒉣	sux
ibbanunna	|UD.HU.HI.NUN|	𒌓𒄷𒄭𒉣	sux
abbununnax~a	|UD.HU.HI.NUN.NA|	𒌓𒄷𒄭𒉣𒈾	sux
abbununnux~a	|UD.HU.HI.NUN.NA|	𒌓𒄷𒄭𒉣𒈾	sux
ibbanunnax~a	|UD.HU.HI.NUN.NA|	𒌓𒄷𒄭𒉣𒈾	sux
abnu	|UD.NI|	𒌓𒉌	sux
atumx	|UD.NI|	𒌓𒉌	sux
nax	|UD.NI|	𒌓𒉌	sux
yax	|UD.NI|	𒌓𒉌	sux
zax	|UD.NI|	𒌓𒉌	sux
adab	|UD.NUN|	𒌓𒉣	sux
adaba	|UD.NUN|	𒌓𒉣	sux
arab	|UD.NUN|	𒌓𒉣	sux
darengal	|UD.NUN|	𒌓𒉣	sux
durungal	|UD.NUN|	𒌓𒉣	sux
isurungal	|UD.NUN|	𒌓𒉣	sux
suruengal	|UD.NUN|	𒌓𒉣	sux
surungal	|UD.NUN|	𒌓𒉣	sux
surugal	|UD.NUN|	𒌓𒉣	sux
turungal	|UD.NUN|	𒌓𒉣	sux
usab	|UD.NUN|	𒌓𒉣	sux
algames	|UD.SAL.HUB₂|	𒌓𒊩𒄸	sux
algamec	|UD.SAL.HUB₂|	𒌓𒊩𒄸	sux
algamis	|UD.SAL.HUB₂|	𒌓𒊩𒄸	sux
carax	|UD.SAR|	𒌓𒊬	sux
caragx	|UD.SAR|	𒌓𒊬	sux
u4-sakar	|UD.SAR|	𒌓𒊬	sux
idx	|UD.ŠEŠ.KI|	𒌓𒋀𒆠	sux
itix	|UD.ŠEŠ.KI|	𒌓𒋀𒆠	sux
babar2	|UD.UD|	𒌓𒌓	sux
babbar2	|UD.UD|	𒌓𒌓	sux
dadag	|UD.UD|	𒌓𒌓	sux
hahad	|UD.UD|	𒌓𒌓	sux
hahhadx	|UD.UD|	𒌓𒌓	sux
huhud	|UD.UD|	𒌓𒌓	sux
larag2	|UD.UD|	𒌓𒌓	sux
larag	|UD.UD.AK|	𒌓𒌓𒀝	sux
itudx	|UD×BAD|	𒌕	sux
itima2	|UD×MI|	𒌖	sux
utima2	|UD×MI|	𒌖	sux
MZL20	|UD×(U.U.U)|	𒌗	sux
a13	|UD×(U.U.U)|	𒌗	sux
arhu	|UD×(U.U.U)|	𒌗	sux
du16	|UD×(U.U.U)|	𒌗	sux
id8	|UD×(U.U.U)|	𒌗	sux
iti	|UD×(U.U.U)|	𒌗	sux
itid	|UD×(U.U.U)|	𒌗	sux
itu	|UD×(U.U.U)|	𒌗	sux
itud	|UD×(U.U.U)|	𒌗	sux
u22	|UD×(U.U.U)|	𒌗	sux
iti7	|UD×(U.U.U).AN.ŠEŠ.KI|	𒌗𒀭𒋀𒆠	sux
murx	|UD×(U.U.U@g)|	𒌘	sux
murux	|UD×(U.U.U@g)|	𒌘	sux
murubx	|UD×(U.U.U@g)|	𒌘	sux
nesajx	|UD×(U.U.U@g)|	𒌘	sux
nisajx	|UD×(U.U.U@g)|	𒌘	sux
sajx	|UD×(U.U.U@g)|	𒌘	sux
zajx	|UD×(U.U.U@g)|	𒌘	sux
murx	UD@g	𒌙	sux
muru13	UD@g	𒌙	sux
murub6	UD@g	𒌙	sux
nesag3	UD@g	𒌙	sux
nisag3	UD@g	𒌙	sux
sagx	UD@g	𒌙	sux
itudx	UD@s	𒌚	sux
ni11	|UD@s.KID|	𒌚𒆤	sux
nigin10	|UD@s.KID|	𒌚𒆤	sux
akcak3	|UD@s.KUŠU₂|	𒌚𒆵	sux
LAK381	|UD@s×BAD|	𒌛	sux
MZL21	|UD@s×BAD|	𒌛	sux
iti2	|UD@s×BAD|	𒌛	sux
itid2	|UD@s×BAD|	𒌛	sux
itu2	|UD@s×BAD|	𒌛	sux
itud2	|UD@s×BAD|	𒌛	sux
rābis,u	UDUG	𒌜	sux
cēdu	UDUG	𒌜	sux
gidim4	UDUG	𒌜	sux
cedu2	UDUG	𒌜	sux
udux	UDUG	𒌜	sux
udug	UDUG	𒌜	sux
utug	UDUG	𒌜	sux
LAK442	LAHŠU	𒇱	sux
lahcu	LAHŠU	𒇱	sux
deh2	UM	𒌝	sux
dehi2	UM	𒌝	sux
dih2	UM	𒌝	sux
dihi2	UM	𒌝	sux
samag	UM	𒌝	sux
sumug	UM	𒌝	sux
cumugx	UM	𒌝	sux
teh2	UM	𒌝	sux
tehi2	UM	𒌝	sux
u16	UM	𒌝	sux
um	UM	𒌝	sux
umu	UM	𒌝	sux
samagx	|UM.LAGAB|	𒌝𒆸	sux
sumugx	|UM.LAGAB|	𒌝𒆸	sux
eme2	|UM.ME|	𒌝𒈨	sux
emeda	|UM.ME|	𒌝𒈨	sux
um-me-da	|UM.ME|	𒌝𒈨	sux
ummeda	|UM.ME|	𒌝𒈨	sux
samag5	|UM×LAGAB|	𒌞	sux
sumug5	|UM×LAGAB|	𒌞	sux
emeda3	|UM×(ME.DA)|	𒌟	sux
ummeda2	|UM×(ME.DA)|	𒌟	sux
samag2	|UM×ŠA₃|	𒌠	sux
sumug2	|UM×ŠA₃|	𒌠	sux
samag3	|UM×U|	𒌡	sux
sumug3	|UM×U|	𒌡	sux
samag4	|UM×U.LAGAB|	𒌡𒆸	sux
sumug4	|UM×U.LAGAB|	𒌡𒆸	sux
LAK289	UMBIN	𒌢	sux
MZL160	UMBIN	𒌢	sux
sigx	UMBIN	𒌢	sux
umbin	UMBIN	𒌢	sux
LAK155	UMUM	𒌣	sux
simug	UMUM	𒌣	sux
umum	UMUM	𒌣	sux
umun2	UMUM	𒌣	sux
abzux	|UMUM×KASKAL|	𒌤	sux
da9	|UMUM×KASKAL|	𒌤	sux
de2	|UMUM×KASKAL|	𒌤	sux
di8	|UMUM×KASKAL|	𒌤	sux
dim6	|UMUM×KASKAL|	𒌤	sux
du19	|UMUM×KASKAL|	𒌤	sux
mum	|UMUM×KASKAL|	𒌤	sux
mun2	|UMUM×KASKAL|	𒌤	sux
ninagal	|UMUM×KASKAL|	𒌤	sux
si7	|UMUM×KASKAL|	𒌤	sux
siu	|UMUM×KASKAL|	𒌤	sux
te5	|UMUM×KASKAL|	𒌤	sux
LAK156	|UMUM×PA|	𒌥	sux
dex	|UMUM×PA|	𒌥	sux
LAK729	UN	𒌦	sux
kalam	UN	𒌦	sux
kalama	UN	𒌦	sux
kanaj	UN	𒌦	sux
kanam	UN	𒌦	sux
u12	UN	𒌦	sux
ug3	UN	𒌦	sux
uga3	UN	𒌦	sux
uj3	UN	𒌦	sux
uku3	UN	𒌦	sux
umx	UN	𒌦	sux
un	UN	𒌦	sux
unu4	UN	𒌦	sux
LAK730	UN@g	𒌧	sux
kalamx	UN@g	𒌧	sux
LAK664	UR	𒌨	sux
MZL828	UR	𒌨	sux
a8	UR	𒌨	sux
aia3	UR	𒌨	sux
kalbu	UR	𒌨	sux
aya3	UR	𒌨	sux
das	UR	𒌨	sux
dac	UR	𒌨	sux
dec3	UR	𒌨	sux
dulx	UR	𒌨	sux
leq	UR	𒌨	sux
li7	UR	𒌨	sux
lig	UR	𒌨	sux
lik	UR	𒌨	sux
liki	UR	𒌨	sux
liq	UR	𒌨	sux
lu6	UR	𒌨	sux
nigx	UR	𒌨	sux
ru7	UR	𒌨	sux
surx	UR	𒌨	sux
cuzi	UR	𒌨	sux
tan8	UR	𒌨	sux
tas	UR	𒌨	sux
tac	UR	𒌨	sux
taca	UR	𒌨	sux
tas,	UR	𒌨	sux
taz	UR	𒌨	sux
tes2	UR	𒌨	sux
tec2	UR	𒌨	sux
tis2	UR	𒌨	sux
tic2	UR	𒌨	sux
tis,2	UR	𒌨	sux
tiz2	UR	𒌨	sux
tac	UR	𒌨	sux
ur	UR	𒌨	sux
ura	UR	𒌨	sux
uru13	UR	𒌨	sux
neca	|UR.MAH|	𒌨𒈤	sux
liri8	|UR%UR|	𒌩	sux
liru8	|UR%UR|	𒌩	sux
lirum8	|UR%UR|	𒌩	sux
ur-ur	|UR%UR|	𒌩	sux
urbigu	|UR%UR|	𒌩	sux
urbingu	|UR%UR|	𒌩	sux
dul9	UR@s	𒌪	sux
cudul4	UR@s	𒌪	sux
cudul5	UR@s	𒌪	sux
cudun5	UR@s	𒌪	sux
cutul5	UR@s	𒌪	sux
cutun5	UR@s	𒌪	sux
tul7	UR@s	𒌪	sux
LAK479	UR₂	𒌫	sux
ur2	UR₂	𒌫	sux
uru8	UR₂	𒌫	sux
urum9	|UR₂×(A.HA)|	𒌬	sux
eren8	|UR₂×HA|	𒌯	sux
erim7	|UR₂×HA|	𒌯	sux
erin9	|UR₂×HA|	𒌯	sux
urux	|UR₂×HA|	𒌯	sux
urum4	|UR₂×HA|	𒌯	sux
ucbar	|UR₂×NUN|	𒌰	sux
ucbur	|UR₂×NUN|	𒌰	sux
ucbarx	|U₂.UR₂|	𒌑𒌫	sux
LAK482	|UR₂×U₂|	𒌱	sux
urum8	|UR₂×U₂|	𒌱	sux
ucbar7	|UR₂×U₂|	𒌱	sux
ucbur7	|UR₂×U₂|	𒌱	sux
muru4	|UR₂×(U₂.AŠ)|	𒌲	sux
murum4	|UR₂×(U₂.AŠ)|	𒌲	sux
ur9	|UR₂×(U₂.AŠ)|	𒌲	sux
uru7	|UR₂×(U₂.AŠ)|	𒌲	sux
urum2	|UR₂×(U₂.AŠ)|	𒌲	sux
ucbar3	|UR₂×(U₂.AŠ)|	𒌲	sux
ucbur3	|UR₂×(U₂.AŠ)|	𒌲	sux
ar...	|UR₂×(U₂.BI)|	𒌳	sux
LAK472	UR₄	𒌴	sux
gur15	UR₄	𒌴	sux
ur4	UR₄	𒌴	sux
ura4	UR₄	𒌴	sux
LAK176	URI	𒌵	sux
ari	URI	𒌵	sux
kinda2	URI	𒌵	sux
tila	URI	𒌵	sux
tilla	URI	𒌵	sux
ur10	URI	𒌵	sux
uri	URI	𒌵	sux
uru19	URI	𒌵	sux
LAK31	URI₃	𒌶	sux
uri3	URI₃	𒌶	sux
urimx	URI₃	𒌶	sux
urin	URI₃	𒌶	sux
uru3	URI₃	𒌶	sux
urun	URI₃	𒌶	sux
LAK591	URU	𒌷	sux
al8	URU	𒌷	sux
ala	URU	𒌷	sux
ale	URU	𒌷	sux
ali	URU	𒌷	sux
alu	URU	𒌷	sux
er4	URU	𒌷	sux
ere	URU	𒌷	sux
eri	URU	𒌷	sux
ir4	URU	𒌷	sux
iri	URU	𒌷	sux
lu8	URU	𒌷	sux
re2	URU	𒌷	sux
ri2	URU	𒌷	sux
ru9	URU	𒌷	sux
cigx	URU	𒌷	sux
u19	URU	𒌷	sux
ulu4	URU	𒌷	sux
uru	URU	𒌷	sux
ala2	|URU.ME.U.U.U|	𒌷𒈨𒌋𒌋𒌋	sux
LAK597	|URU×A|	𒌸	sux
MZL81	|URU×A|	𒌸	sux
arx	|URU×A|	𒌸	sux
ararim	|URU×A|	𒌸	sux
nagx	|URU×A|	𒌸	sux
ru14	|URU×A|	𒌸	sux
uru18	|URU×A|	𒌸	sux
urua	|URU×A|	𒌸	sux
LAK594	|URU×AŠGAB|	𒌹	sux
LAK649	|URU×BAR|	𒌺	sux
barimx	|URU×BAR|	𒌺	sux
kin5	|URU×BAR|	𒌺	sux
ukken	|URU×BAR|	𒌺	sux
ukkin	|URU×BAR|	𒌺	sux
unken	|URU×BAR|	𒌺	sux
unkin	|URU×BAR|	𒌺	sux
MZL30~a	|KA×BAR|	𒅞	sux
unkinx~a	|KA×BAR|	𒅞	sux
MZL76	|URU×GA|	𒌼	sux
cakir3	|URU×GA|	𒌼	sux
cakira3	|URU×GA|	𒌼	sux
cikira3	|URU×GA|	𒌼	sux
aralix	|URU×GAL|	𒌽	sux
urugalx	|URU×GAL|	𒌽	sux
LAK601	|URU×GAN₂@t|	𒌾	sux
MZL74	|URU×GAN₂@t|	𒌾	sux
ru11	|URU×GAN₂@t|	𒌾	sux
ubx	|URU×GAN₂@t|	𒌾	sux
uru11	|URU×GAN₂@t|	𒌾	sux
urub	|URU×GAN₂@t|	𒌾	sux
urutamga	|URU×GAN₂@t|	𒌾	sux
LAK603	|URU×GAR|	𒌿	sux
MZL83	|URU×GAR|	𒌿	sux
erim3	|URU×GAR|	𒌿	sux
erimmax	|URU×GAR|	𒌿	sux
erin3	|URU×GAR|	𒌿	sux
irimmax	|URU×GAR|	𒌿	sux
LAK602	|URU×GU|	𒍀	sux
MZL84	|URU×GU|	𒍀	sux
gur5	|URU×GU|	𒍀	sux
guru5	|URU×GU|	𒍀	sux
guruc3	|URU×GU|	𒍀	sux
kur12	|URU×GU|	𒍀	sux
cakir	|URU×GU|	𒍀	sux
cakira	|URU×GU|	𒍀	sux
cakiri	|URU×GU|	𒍀	sux
cegx	|URU×GU|	𒍀	sux
cigx	|URU×GU|	𒍀	sux
curumx	|URU×GU|	𒍀	sux
MZL69~a	|KA×GU|	𒅫	sux
gux~a	|KA×GU|	𒅫	sux
gur5~a	|KA×GU|	𒅫	sux
guru5~a	|KA×GU|	𒅫	sux
cakir~a	|KA×GU|	𒅫	sux
MZL82	|URU×HA|	𒍁	sux
iriceb	|URU×HA|	𒍁	sux
uruceb	|URU×HA|	𒍁	sux
urucib	|URU×HA|	𒍁	sux
MZL79	|URU×IGI|	𒍂	sux
nūr-ili	|URU×IGI|	𒍂	sux
asax	|URU×IGI|	𒍂	sux
asal	|URU×IGI|	𒍂	sux
asar	|URU×IGI|	𒍂	sux
asara	|URU×IGI|	𒍂	sux
asari	|URU×IGI|	𒍂	sux
asaru	|URU×IGI|	𒍂	sux
bancurx	|URU×IGI|	𒍂	sux
ilumer2	|URU×IGI|	𒍂	sux
ichuru2	|URU×IGI|	𒍂	sux
silig	|URU×IGI|	𒍂	sux
cilig	|URU×IGI|	𒍂	sux
MZL59~b	|KA×IGI|	𒅭	sux
asalx~b	|KA×IGI|	𒅭	sux
silig7~b	|KA×IGI|	𒅭	sux
cilig7~b	|KA×IGI|	𒅭	sux
bunx	|URU×IM|	𒍃	sux
LAK596	|URU×IŠ|	𒍄	sux
LAK648	|URU×MIN|	𒍇	sux
MZL80	|URU×MIN|	𒍇	sux
gal3	|URU×MIN|	𒍇	sux
gicgal	|URU×MIN|	𒍇	sux
jicgal	|URU×MIN|	𒍇	sux
lu7	|URU×MIN|	𒍇	sux
qal3	|URU×MIN|	𒍇	sux
suk3	|URU×MIN|	𒍇	sux
u18	|URU×MIN|	𒍇	sux
ul12	|URU×MIN|	𒍇	sux
ulu3	|URU×MIN|	𒍇	sux
uru17	|URU×MIN|	𒍇	sux
zik3	|URU×MIN|	𒍇	sux
LAK595	|URU×SIG₄|	𒍊	sux
cegx	|URU×ŠE|	𒍉	sux
cigx	|URU×ŠE|	𒍉	sux
MZL72	|URU×TU|	𒍋	sux
sigx	|URU×TU|	𒍋	sux
ceg5	|URU×TU|	𒍋	sux
cig5	|URU×TU|	𒍋	sux
cecceg	|URU×TU.URU×TU|	𒍋𒍋	sux
MZL78	|URU×(U.GUD)|	𒍌	sux
LAK598	|URU×UD|	𒍍	sux
MZL77	|URU×UD|	𒍍	sux
ararimx	|URU×UD|	𒍍	sux
erarimx	|URU×UD|	𒍍	sux
erix	|URU×UD|	𒍍	sux
erim6	|URU×UD|	𒍍	sux
erin6	|URU×UD|	𒍍	sux
ru4	|URU×UD|	𒍍	sux
uru2	|URU×UD|	𒍍	sux
urumx	|URU×UD|	𒍍	sux
ururim	|URU×UD|	𒍍	sux
urucibx	|URU×UD|	𒍍	sux
urutamga2	|URU×UD|	𒍍	sux
LAK716	|URU×URUDA|	𒍎	sux
MZL75	|URU×URUDA|	𒍎	sux
bansur	|URU×URUDA|	𒍎	sux
bancur	|URU×URUDA|	𒍎	sux
bancura	|URU×URUDA|	𒍎	sux
pancur	|URU×URUDA|	𒍎	sux
silig5	|URU×URUDA|	𒍎	sux
cilig5	|URU×URUDA|	𒍎	sux
LAK604	URUDA	𒍏	sux
da5	URUDA	𒍏	sux
dab6	URUDA	𒍏	sux
mebulug	URUDA	𒍏	sux
menbulug	URUDA	𒍏	sux
minbulug	URUDA	𒍏	sux
cen2	URUDA	𒍏	sux
urud	URUDA	𒍏	sux
uruda	URUDA	𒍏	sux
urudu	URUDA	𒍏	sux
samanur	|IŠ.URUDA|	𒍏𒅖𒍏	sux
samannu	|IŠ.URUDA|	𒍏𒅖𒍏	sux
camanur	|IŠ.URUDA|	𒍏𒅖𒍏	sux
cacamanur	|IŠ.URUDA|	𒍏𒅖𒍏	sux
ceknu	|IŠ.URUDA|	𒍏𒅖𒍏	sux
cem7	|IŠ.URUDA|	𒍏𒅖𒍏	sux
cen5	|IŠ.URUDA|	𒍏𒅖𒍏	sux
samagx	|URUDA×U|	𒍐	sux
sumugx	|URUDA×U|	𒍐	sux
samagx	|URUDA×U.LAGAB|	𒍐𒆸	sux
sumugx	|URUDA×U.LAGAB|	𒍐𒆸	sux
samagx	|URUDA×U.U|	𒍐𒌋	sux
ussu	USSU	𒑄	sux
8(dic)@v	USSU	𒑄	sux
ussu3	USSU₃	𒑅	sux
8(ac@v)	USSU₃	𒑅	sux
8(ac@v@c)	USSU₃	𒑅	sux
LAK58	UŠ	𒍑	sux
MZL381	UŠ	𒍑	sux
gec3	UŠ	𒍑	sux
gic3	UŠ	𒍑	sux
gurucx	UŠ	𒍑	sux
jec3	UŠ	𒍑	sux
jic3	UŠ	𒍑	sux
ic10	UŠ	𒍑	sux
mecx	UŠ	𒍑	sux
micx	UŠ	𒍑	sux
ned	UŠ	𒍑	sux
nid	UŠ	𒍑	sux
ninta	UŠ	𒍑	sux
nintah	UŠ	𒍑	sux
nintahu	UŠ	𒍑	sux
net	UŠ	𒍑	sux
net	UŠ	𒍑	sux
nit	UŠ	𒍑	sux
nita	UŠ	𒍑	sux
nitah	UŠ	𒍑	sux
nitahu	UŠ	𒍑	sux
nittax	UŠ	𒍑	sux
nit	UŠ	𒍑	sux
unu8	UŠ	𒍑	sux
us2	UŠ	𒍑	sux
usa2	UŠ	𒍑	sux
usu2	UŠ	𒍑	sux
uś	UŠ	𒍑	sux
uc	UŠ	𒍑	sux
us,2	UŠ	𒍑	sux
uz2	UŠ	𒍑	sux
uttu5	|UŠ.BAR|	𒍑𒁇	sux
utu5	|UŠ.BAR|	𒍑𒁇	sux
arahx	|UŠ.BU.DA|	𒍑𒁍𒁕	sux
gidlam2	|UŠ.DAM|	𒍑𒁮	sux
gitlam2	|UŠ.DAM|	𒍑𒁮	sux
jidlam2	|UŠ.DAM|	𒍑𒁮	sux
jitlam2	|UŠ.DAM|	𒍑𒁮	sux
madax	|UŠ.DAM|	𒍑𒁮	sux
nidalam2	|UŠ.DAM|	𒍑𒁮	sux
nidlam2	|UŠ.DAM|	𒍑𒁮	sux
nitadam2	|UŠ.DAM|	𒍑𒁮	sux
nitalam2	|UŠ.DAM|	𒍑𒁮	sux
nitlam2	|UŠ.DAM|	𒍑𒁮	sux
bunga	|UŠ.GA|	𒍑𒂵	sux
bungu	|UŠ.GA|	𒍑𒂵	sux
galx	|UŠ.KU|	𒍑𒆪	sux
gala	|UŠ.KU|	𒍑𒆪	sux
nitax	|UŠ.KU|	𒍑𒆪	sux
dida2	|UŠ.SA|	𒍑𒊓	sux
pihu5	|UŠ.SA|	𒍑𒊓	sux
gidlam3	|UŠ.SAL.DAM|	𒍑𒊩𒁮	sux
gitlam3	|UŠ.SAL.DAM|	𒍑𒊩𒁮	sux
jidlam3	|UŠ.SAL.DAM|	𒍑𒊩𒁮	sux
nidalam3	|UŠ.SAL.DAM|	𒍑𒊩𒁮	sux
nidlam3	|UŠ.SAL.DAM|	𒍑𒊩𒁮	sux
nitalam3	|UŠ.SAL.DAM|	𒍑𒊩𒁮	sux
jitlam3	|UŠ.SAL.DAM|	𒍑𒊩𒁮	sux
nitlam3	|UŠ.SAL.DAM|	𒍑𒊩𒁮	sux
uctu2	|UŠ.TUG₂.PI|	𒍑𒌆𒉿	sux
uctug2	|UŠ.TUG₂.PI|	𒍑𒌆𒉿	sux
kac3	|UŠ×A|	𒍒	sux
kisi	|UŠ×A|	𒍒	sux
galax	|UŠ×KU|	𒍓	sux
gecx	|UŠ×KUR|	𒍔	sux
LAK60	|UŠ×TAK₄|	𒍕	sux
MZL382	|UŠ×TAK₄|	𒍕	sux
dan6	|UŠ×TAK₄|	𒍕	sux
tan6	|UŠ×TAK₄|	𒍕	sux
LAK672a	UŠX	𒍖	sux
ucx	UŠX	𒍖	sux
KWU089	UŠUMX	𒍘	sux
ucumx	UŠUMX	𒍘	sux
utudi	UTUKI	𒍙	sux
utuki	UTUKI	𒍙	sux
LAK778	UZ₃	𒍚	sux
surx	UZ₃	𒍚	sux
ud5	UZ₃	𒍚	sux
uda5	UZ₃	𒍚	sux
us3	UZ₃	𒍚	sux
ut5	UZ₃	𒍚	sux
uz3	UZ₃	𒍚	sux
uza3	UZ₃	𒍚	sux
uzud	UZ₃	𒍚	sux
guana	|UZ₃.KASKAL|	𒍚𒆜	sux
qablu	|UZ₃×KASKAL|	𒍛	sux
mex	|UZ₃×KASKAL|	𒍛	sux
LAK350	UZU	𒍜	sux
cer4	UZU	𒍜	sux
ceru	UZU	𒍜	sux
cir4	UZU	𒍜	sux
ciram	UZU	𒍜	sux
cirim	UZU	𒍜	sux
ciru	UZU	𒍜	sux
cirum	UZU	𒍜	sux
usux	UZU	𒍜	sux
uzu	UZU	𒍜	sux
x	X	░░	sux
n	X	░░	sux
sa3	ZA	𒍝	sux
s,a	ZA	𒍝	sux
za	ZA	𒍝	sux
zagga2	ZA	𒍝	sux
cubax	|ZA.AN.MUŠ₃@g|	𒍝𒀭𒈽	sux
zannarux	|ZA.AN.MUŠ₃@g|	𒍝𒀭𒈽	sux
nir2	|ZA.DUN₃@g|	𒍝𒂆	sux
nir7	|ZA.DUN₃@g@g|	𒍝𒂇	sux
LAK799	|ZA.GUL|	𒍝𒄢	sux
gagx	|ZA.GUL|	𒍝𒄢	sux
gug	|ZA.GUL|	𒍝𒄢	sux
guq	|ZA.GUL|	𒍝𒄢	sux
nir5	|ZA.IB|	𒍝𒅁	sux
gectaex	|ZA.KUR|	𒍝𒆳	sux
gicta)e2	|ZA.KUR|	𒍝𒆳	sux
gicta)i2	|ZA.KUR|	𒍝𒆳	sux
nira2	|ZA.KUR|	𒍝𒆳	sux
zagindur	|ZA.KUR.A|	𒍝𒆳𒀀	sux
halbax	|ZA.MUŠ₃|	𒍝𒈹	sux
suba2	|ZA.MUŠ₃|	𒍝𒈹	sux
cub8	|ZA.MUŠ₃|	𒍝𒈹	sux
cuba2	|ZA.MUŠ₃|	𒍝𒈹	sux
cubux	|ZA.MUŠ₃|	𒍝𒈹	sux
zanaru2	|ZA.MUŠ₃|	𒍝𒈹	sux
zannaru2	|ZA.MUŠ₃|	𒍝𒈹	sux
sugal2	|ZA.MUŠ₃.AB@g|	𒍝𒈹𒀕	sux
zabala2	|ZA.MUŠ₃.AB@g|	𒍝𒈹𒀕	sux
zabalam2	|ZA.MUŠ₃.AB@g|	𒍝𒈹𒀕	sux
halba3	|ZA.MUŠ₃@g|	𒍝𒈽	sux
halbi3	|ZA.MUŠ₃@g|	𒍝𒈽	sux
halbu3	|ZA.MUŠ₃@g|	𒍝𒈽	sux
suba	|ZA.MUŠ₃@g|	𒍝𒈽	sux
cub7	|ZA.MUŠ₃@g|	𒍝𒈽	sux
cuba	|ZA.MUŠ₃@g|	𒍝𒈽	sux
zannaru	|ZA.MUŠ₃@g|	𒍝𒈽	sux
panu	|ZA.MUŠ₃@g.AB@g|	𒍝𒈽𒀕	sux
sugal	|ZA.MUŠ₃@g.AB@g|	𒍝𒈽𒀕	sux
unu11	|ZA.MUŠ₃@g.AB@g|	𒍝𒈽𒀕	sux
zabala	|ZA.MUŠ₃@g.AB@g|	𒍝𒈽𒀕	sux
zabalam	|ZA.MUŠ₃@g.AB@g|	𒍝𒈽𒀕	sux
cucux	|ZA.MUŠ₃@g.EREN|	𒍝𒈽𒂞	sux
nir3	|ZA.NIM|	𒍝𒉏	sux
nira3	|ZA.NIM|	𒍝𒉏	sux
nir4	|ZA.SU|	𒍝𒋢	sux
gectae	|(4×ZA)×KUR|	𒍟	sux
gictae	|(4×ZA)×KUR|	𒍟	sux
gicta)e	|(4×ZA)×KUR|	𒍟	sux
gicta)i	|(4×ZA)×KUR|	𒍟	sux
jectae	|(4×ZA)×KUR|	𒍟	sux
ad4	ZA@t	𒍞	sux
addax	ZA@t	𒍞	sux
addu4	ZA@t	𒍞	sux
LAK283	ZAG	𒍠	sux
bute	ZAG	𒍠	sux
buti	ZAG	𒍠	sux
butu	ZAG	𒍠	sux
en7	ZAG	𒍠	sux
puta	ZAG	𒍠	sux
pute	ZAG	𒍠	sux
puti	ZAG	𒍠	sux
putu	ZAG	𒍠	sux
sax	ZAG	𒍠	sux
sak6	ZAG	𒍠	sux
s,ak	ZAG	𒍠	sux
za3	ZAG	𒍠	sux
zag	ZAG	𒍠	sux
zak	ZAG	𒍠	sux
zaq	ZAG	𒍠	sux
zik0	ZAG	𒍠	sux
usug	|ZAG.AN|	𒍠𒀭	sux
uzug	|ZAG.AN|	𒍠𒀭	sux
būdu	|ZAG.GA|	𒍠𒂵	sux
būdu	|ZAG.HA|	𒍠𒄩	sux
enku	|ZAG.HA|	𒍠𒄩	sux
enkud	|ZAG.HA|	𒍠𒄩	sux
essad	|ZAG.HA|	𒍠𒄩	sux
ecsad	|ZAG.HA|	𒍠𒄩	sux
eccad	|ZAG.HA|	𒍠𒄩	sux
LAK538	ZE₂	𒍢	sux
se20	ZE₂	𒍢	sux
si20	ZE₂	𒍢	sux
s,e	ZE₂	𒍢	sux
s,i	ZE₂	𒍢	sux
ze2	ZE₂	𒍢	sux
zi2	ZE₂	𒍢	sux
LAK468	ZI	𒍣	sux
MZL140	ZI	𒍣	sux
se2	ZI	𒍣	sux
si2	ZI	𒍣	sux
s,e2	ZI	𒍣	sux
s,i2	ZI	𒍣	sux
ze	ZI	𒍣	sux
zi	ZI	𒍣	sux
zid	ZI	𒍣	sux
zig3	ZI	𒍣	sux
ballatu	|ZI.ME.U.U.U|	𒍣𒈨𒌋𒌋𒌋	sux
MZL104	|ZI&ZI.A|	𒍤𒀀	sux
ackix	|ZI&ZI.A|	𒍤𒀀	sux
ginx	|ZI&ZI.A|	𒍤𒀀	sux
gugx	|ZI&ZI.A|	𒍤𒀀	sux
lamahucx	|ZI&ZI.A|	𒍤𒀀	sux
mudx	|ZI&ZI.A|	𒍤𒀀	sux
numunx	|ZI&ZI.A|	𒍤𒀀	sux
suluhu3	|ZI&ZI.A|	𒍤𒀀	sux
sulumhi3	|ZI&ZI.A|	𒍤𒀀	sux
cubx	|ZI&ZI.A|	𒍤𒀀	sux
/cumun/	|ZI&ZI.A|	𒍤𒀀	sux
zukum	|ZI&ZI.A|	𒍤𒀀	sux
zuluhu3	|ZI&ZI.A|	𒍤𒀀	sux
zulumhi3	|ZI&ZI.A|	𒍤𒀀	sux
LAK469~a	|ZI&ZI|	𒍤	sux
KWU127~a	|ZI&ZI|	𒍤	sux
MZL101~a	|ZI&ZI|	𒍤	sux
MZL103	|ZI&ZI.EŠ₂|	𒍤𒂠	sux
cub5	|ZI&ZI.EŠ₂|	𒍤𒂠	sux
MZL102	|ZI&ZI.LAGAB|	𒍤𒆸	sux
acki	|ZI&ZI.LAGAB|	𒍤𒆸	sux
gin4	|ZI&ZI.LAGAB|	𒍤𒆸	sux
gug4	|ZI&ZI.LAGAB|	𒍤𒆸	sux
lamahuc	|ZI&ZI.LAGAB|	𒍤𒆸	sux
mud7	|ZI&ZI.LAGAB|	𒍤𒆸	sux
numun2	|ZI&ZI.LAGAB|	𒍤𒆸	sux
suluhu3	|ZI&ZI.LAGAB|	𒍤𒆸	sux
sulumhi3	|ZI&ZI.LAGAB|	𒍤𒆸	sux
cub5	|ZI&ZI.LAGAB|	𒍤𒆸	sux
/cumun/	|ZI&ZI.LAGAB|	𒍤𒆸	sux
zukum	|ZI&ZI.LAGAB|	𒍤𒆸	sux
zuluhu3	|ZI&ZI.LAGAB|	𒍤𒆸	sux
zulumhi3	|ZI&ZI.LAGAB|	𒍤𒆸	sux
LAK469~a	|ZI&ZI|	𒍤	sux
KWU127~a	|ZI&ZI|	𒍤	sux
MZL101~a	|ZI&ZI|	𒍤	sux
gugx~a	|ZI&ZI|	𒍤	sux
sumx~a	|ZI&ZI|	𒍤	sux
hac2	ZIG	𒍨	sux
hec2	ZIG	𒍨	sux
hic2	ZIG	𒍨	sux
s,ib2	ZIG	𒍨	sux
zaq4	ZIG	𒍨	sux
zeb2	ZIG	𒍨	sux
zib2	ZIG	𒍨	sux
zig	ZIG	𒍨	sux
zik	ZIG	𒍨	sux
ziq	ZIG	𒍨	sux
ziqi	ZIG	𒍨	sux
LAK162b	ZIZ₂	𒍩	sux
ziz2	ZIZ₂	𒍩	sux
LAK291	ZU	𒍪	sux
MZL15	ZU	𒍪	sux
ka14	ZU	𒍪	sux
ki6	ZU	𒍪	sux
su2	ZU	𒍪	sux
s,u2	ZU	𒍪	sux
zax	ZU	𒍪	sux
zu	ZU	𒍪	sux
LAK292	|ZU.AB|	𒍪𒀊	sux
absu	|ZU.AB|	𒍪𒀊	sux
abzu	|ZU.AB|	𒍪𒀊	sux
LAK117	ZU₅	𒍫	sux
zu5	ZU₅	𒍫	sux
azu	|ZU₅×A|	𒍬	sux
ucbar2	|ZU₅×A|	𒍬	sux
ucbur2	|ZU₅×A|	𒍬	sux
uzu2	|ZU₅×A|	𒍬	sux
zabar2	ZUBUR	𒍭	sux
zubur	ZUBUR	𒍭	sux
LAK520	ZUM	𒍮	sux
MZL884	ZUM	𒍮	sux
garig	ZUM	𒍮	sux
gazum2	ZUM	𒍮	sux
hal2	ZUM	𒍮	sux
hac4	ZUM	𒍮	sux
ri4	ZUM	𒍮	sux
rig2	ZUM	𒍮	sux
rij2	ZUM	𒍮	sux
rik2	ZUM	𒍮	sux
rimx	ZUM	𒍮	sux
riq2	ZUM	𒍮	sux
sim5	ZUM	𒍮	sux
su14	ZUM	𒍮	sux
sum2	ZUM	𒍮	sux
cu15	ZUM	𒍮	sux
s,im	ZUM	𒍮	sux
s,u	ZUM	𒍮	sux
s,um	ZUM	𒍮	sux
zu3	ZUM	𒍮	sux
zum	ZUM	𒍮	sux
2(ac)	2(AŠ)	𒐀	sux
2(ac@c)	2(AŠ)	𒐀	sux
2(iku)	2(AŠ)	𒐀	sux
3(ac)	3(AŠ)	𒐁	sux
3(ac@c)	3(AŠ)	𒐁	sux
3(iku)	3(AŠ)	𒐁	sux
4(ac)	4(AŠ)	𒐂	sux
4(ac@c)	4(AŠ)	𒐂	sux
4(iku)	4(AŠ)	𒐂	sux
5(ac)	5(AŠ)	𒐃	sux
5(ac@c)	5(AŠ)	𒐃	sux
5(iku)	5(AŠ)	𒐃	sux
6(ac)	6(AŠ)	𒐄	sux
6(ac@c)	6(AŠ)	𒐄	sux
7(ac)	7(AŠ)	𒐅	sux
7(ac@c)	7(AŠ)	𒐅	sux
8(ac)	8(AŠ)	𒐆	sux
8(ac@c)	8(AŠ)	𒐆	sux
9(ac)	9(AŠ)	𒐇	sux
9(ac@c)	9(AŠ)	𒐇	sux
3(ac@v)	3(AŠ)	𒐺	sux
3(ac@v@c)	3(AŠ)	𒐺	sux
ec16	3(AŠ)	𒐺	sux
3(ac)@v	3(AŠ)	𒐻	sux
3(ac@c)@v	3(AŠ)	𒐻	sux
3(iku)@v	3(AŠ)	𒐻	sux
ec21	3(AŠ)	𒐻	sux
4(ac@v)	4(AŠ)	𒐽	sux
4(ac@v@c)	4(AŠ)	𒐽	sux
limmu4	4(AŠ)	𒐽	sux
6(ac@v)	6(AŠ)	𒑀	sux
6(ac@v@c)	6(AŠ)	𒑀	sux
ac9	6(AŠ)	𒑀	sux
7(ac@v)	7(AŠ)	𒑁	sux
7(ac@v@c)	7(AŠ)	𒑁	sux
imin3	7(AŠ)	𒑁	sux
LAK185	2(AŠ@t)	𒑊	sux
2(ac@t)	2(AŠ@t)	𒑊	sux
2(ac@t@c)	2(AŠ@t)	𒑊	sux
3(ac@t)	3(AŠ@t)	𒑋	sux
3(ac@t@c)	3(AŠ@t)	𒑋	sux
4(ac@t)	4(AŠ@t)	𒑌	sux
4(ac@t@c)	4(AŠ@t)	𒑌	sux
LAK193	5(AŠ@t)	𒑍	sux
5(ac@t)	5(AŠ@t)	𒑍	sux
5(ac@t@c)	5(AŠ@t)	𒑍	sux
6(ac@t)	6(AŠ@t)	𒑎	sux
6(ac@t@c)	6(AŠ@t)	𒑎	sux
MZL122	1(BAN₂)	𒑏	sux
ban2	1(BAN₂)	𒑏	sux
banda2	1(BAN₂)	𒑏	sux
sutu	1(BAN₂)	𒑏	sux
1(ban2)	1(BAN₂)	𒑏	sux
1(ban2@c)	1(BAN₂)	𒑏	sux
ban2@c	1(BAN₂)	𒑏	sux
ban2@v	1(BAN₂)	𒑏	sux
2(ban2)	2(BAN₂)	𒑐	sux
2(ban2@c)	2(BAN₂)	𒑐	sux
bamen	2(BAN₂)	𒑐	sux
bamin	2(BAN₂)	𒑐	sux
banmin	2(BAN₂)	𒑐	sux
3(ban2)	3(BAN₂)	𒑑	sux
3(ban2@c)	3(BAN₂)	𒑑	sux
4(ban2)	4(BAN₂)	𒑒	sux
4(ban2@c)	4(BAN₂)	𒑒	sux
5(ban2)	5(BAN₂)	𒑔	sux
5(ban2@c)	5(BAN₂)	𒑔	sux
4(ban2@v)	4(BAN₂@v)	𒑓	sux
4(ban2@v@c)	4(BAN₂@v)	𒑓	sux
4(ban2)@v	4(BAN₂@v)	𒑓	sux
4(ban2@c)@v	4(BAN₂@v)	𒑓	sux
5(ban2)@v	5(BAN₂@v)	𒑕	sux
5(ban2@c)@v	5(BAN₂@v)	𒑕	sux
5(ban2@v)	5(BAN₂@v)	𒑕	sux
5(ban2@v@c)	5(BAN₂@v)	𒑕	sux
LAK808	U@g	𒐴	sux
bur)u	U@g	𒐴	sux
bur)u@c	U@g	𒐴	sux
1(bur)u)	U@g	𒐴	sux
1(bur)u@c)	U@g	𒐴	sux
2(bur)u)	2(BURU)	𒐵	sux
2(bur)u@c)	2(BURU)	𒐵	sux
3(bur)u)	3(BURU)	𒐶	sux
3(bur)u@c)	3(BURU)	𒐶	sux
4(bur)u)	4(BURU)	𒐸	sux
4(bur)u@c)	4(BURU)	𒐸	sux
5(bur)u)	5(BURU)	𒐹	sux
5(bur)u@c)	5(BURU)	𒐹	sux
3(bur)u)@v	3(BURU@v)	𒐷	sux
3(bur)u@c)@v	3(BURU@v)	𒐷	sux
2(car2)	2(ŠAR₂)	𒐣	sux
2(car2@c)	2(ŠAR₂)	𒐣	sux
3(car2)	3(ŠAR₂)	𒐤	sux
3(car2@c)	3(ŠAR₂)	𒐤	sux
4(car2)	4(ŠAR₂)	𒐦	sux
4(car2@c)	4(ŠAR₂)	𒐦	sux
5(car2)	5(ŠAR₂)	𒐧	sux
5(car2@c)	5(ŠAR₂)	𒐧	sux
6(car2)	6(ŠAR₂)	𒐨	sux
6(car2@c)	6(ŠAR₂)	𒐨	sux
7(car2)	7(ŠAR₂)	𒐩	sux
7(car2@c)	7(ŠAR₂)	𒐩	sux
8(car2)	8(ŠAR₂)	𒐪	sux
8(car2@c)	8(ŠAR₂)	𒐪	sux
9(car2)	9(ŠAR₂)	𒐫	sux
9(car2@c)	9(ŠAR₂)	𒐫	sux
3(car2)@v	3(ŠAR₂)@v	𒐥	sux
3(car2@c)@v	3(ŠAR₂)@v	𒐥	sux
1(caru)	1(ŠARU)	𒐬	sux
1(caru@c)	1(ŠARU)	𒐬	sux
1(car)u)	1(ŠARU)	𒐬	sux
1(car)u@c)	1(ŠARU)	𒐬	sux
2(caru)	2(ŠARU)	𒐭	sux
2(caru@c)	2(ŠARU)	𒐭	sux
2(car)u)	2(ŠARU)	𒐭	sux
2(car)u@c)	2(ŠARU)	𒐭	sux
3(caru)	3(ŠARU)	𒐮	sux
3(caru@c)	3(ŠARU)	𒐮	sux
3(car)u)	3(ŠARU)	𒐮	sux
3(car)u@c)	3(ŠARU)	𒐮	sux
4(caru)	4(ŠARU)	𒐰	sux
4(caru@c)	4(ŠARU)	𒐰	sux
4(car)u)	4(ŠARU)	𒐰	sux
4(car)u@c)	4(ŠARU)	𒐰	sux
5(caru)	5(ŠARU)	𒐱	sux
5(caru@c)	5(ŠARU)	𒐱	sux
5(car)u)	5(ŠARU)	𒐱	sux
5(car)u@c)	5(ŠARU)	𒐱	sux
3(caru)@v	3(ŠARU@v)	𒐯	sux
3(caru@c)@v	3(ŠARU@v)	𒐯	sux
3(car)u)@v	3(ŠARU@v)	𒐯	sux
3(car)u@c)@v	3(ŠARU@v)	𒐯	sux
3(dic)	3(DIŠ)	𒐈	sux
3(dic@c)	3(DIŠ)	𒐈	sux
4(dic)	4(DIŠ)	𒐉	sux
4(dic@c)	4(DIŠ)	𒐉	sux
limx	4(DIŠ)	𒐉	sux
limmu5	4(DIŠ)	𒐉	sux
limu5	4(DIŠ)	𒐉	sux
4(barig)	4(DIŠ)	𒐉	sux
nigidalimmu	4(DIŠ)	𒐉	sux
4(barig@c)	4(DIŠ)	𒐉	sux
4(bariga)	4(DIŠ)	𒐉	sux
4(bariga@c)	4(DIŠ)	𒐉	sux
nilimmu	4(DIŠ)	𒐉	sux
5(dic)	5(DIŠ)	𒐊	sux
5(dic@c)	5(DIŠ)	𒐊	sux
i2	5(DIŠ)	𒐊	sux
ia2	5(DIŠ)	𒐊	sux
6(dic)	6(DIŠ)	𒐋	sux
6(dic@c)	6(DIŠ)	𒐋	sux
ac3	6(DIŠ)	𒐋	sux
aca3	6(DIŠ)	𒐋	sux
acca3	6(DIŠ)	𒐋	sux
decax	6(DIŠ)	𒐋	sux
7(dic)	7(DIŠ)	𒐌	sux
7(dic@c)	7(DIŠ)	𒐌	sux
7(dic)@v	7(DIŠ)	𒑂	sux
7(dic@c)@v	7(DIŠ)	𒑂	sux
iminx	7(DIŠ)	𒑂	sux
7(dic)@v~b	7(DIŠ)	𒑃	sux
7(dic@c)@v~b	7(DIŠ)	𒑃	sux
iminx	7(DIŠ)	𒑃	sux
8(dic)	8(DIŠ)	𒐍	sux
8(dic@c)	8(DIŠ)	𒐍	sux
ussu	8(DIŠ)	𒐍	sux
usa	8(DIŠ)	𒐍	sux
elimmux	9(DIŠ)	𒐎	sux
ilimx	9(DIŠ)	𒐎	sux
ilimmux	9(DIŠ)	𒐎	sux
9(dic)~d	9(DIŠ)	𒐎	sux
9(dic@c)~a	9(DIŠ)	𒐎	sux
9(dic)@v~a	9(DIŠ)	𒑇	sux
9(dic@c)@v~a	9(DIŠ)	𒑇	sux
ilimmu3	9(DIŠ)	𒑇	sux
9(dic)@v	9(DIŠ)	𒑈	sux
9(dic@c)@v	9(DIŠ)	𒑈	sux
ilimmu4	9(DIŠ)	𒑈	sux
9(dic@v)	9(DIŠ)	𒑉	sux
9(dic@v@c)	9(DIŠ)	𒑉	sux
ilimmux	9(DIŠ)	𒑉	sux
MZL114	1(EŠE₃)	𒑘	sux
1(ece3)	1(EŠE₃)	𒑘	sux
1(ece3@c)	1(EŠE₃)	𒑘	sux
ece3@c	1(EŠE₃)	𒑘	sux
2(ece3)	2(EŠE₃)	𒑙	sux
2(ece3@c)	2(EŠE₃)	𒑙	sux
gec2	1(GEŠ₂)	𒐕	sux
gecta	1(GEŠ₂)	𒐕	sux
gi3	1(GEŠ₂)	𒐕	sux
gic2	1(GEŠ₂)	𒐕	sux
jec2	1(GEŠ₂)	𒐕	sux
jic2	1(GEŠ₂)	𒐕	sux
1(gec2)	1(GEŠ₂)	𒐕	sux
1(gec2@c)	1(GEŠ₂)	𒐕	sux
gec2@c	1(GEŠ₂)	𒐕	sux
jec2@c	1(GEŠ₂)	𒐕	sux
2(gec2)	2(GEŠ₂)	𒐖	sux
2(gec2@c)	2(GEŠ₂)	𒐖	sux
3(gec2)	3(GEŠ₂)	𒐗	sux
3(gec2@c)	3(GEŠ₂)	𒐗	sux
4(gec2)	4(GEŠ₂)	𒐘	sux
4(gec2@c)	4(GEŠ₂)	𒐘	sux
5(gec2)	5(GEŠ₂)	𒐙	sux
5(gec2@c)	5(GEŠ₂)	𒐙	sux
6(gec2)	6(GEŠ₂)	𒐚	sux
6(gec2@c)	6(GEŠ₂)	𒐚	sux
7(gec2)	7(GEŠ₂)	𒐛	sux
7(gec2@c)	7(GEŠ₂)	𒐛	sux
8(gec2)	8(GEŠ₂)	𒐜	sux
8(gec2@c)	8(GEŠ₂)	𒐜	sux
9(gec2)	9(GEŠ₂)	𒐝	sux
9(gec2@c)	9(GEŠ₂)	𒐝	sux
1(gecu)	1(GEŠU)	𒐞	sux
1(gecu@c)	1(GEŠU)	𒐞	sux
1(gec)u)	1(GEŠU)	𒐞	sux
1(gec)u@c)	1(GEŠU)	𒐞	sux
gec)u	1(GEŠU)	𒐞	sux
jec)u	1(GEŠU)	𒐞	sux
jec)u@c	1(GEŠU)	𒐞	sux
2(gecu)	2(GEŠU)	𒐟	sux
2(gecu@c)	2(GEŠU)	𒐟	sux
2(gec)u)	2(GEŠU)	𒐟	sux
2(gec)u@c)	2(GEŠU)	𒐟	sux
3(gecu)	3(GEŠU)	𒐠	sux
3(gecu@c)	3(GEŠU)	𒐠	sux
3(gec)u)	3(GEŠU)	𒐠	sux
3(gec)u@c)	3(GEŠU)	𒐠	sux
4(gecu)	4(GEŠU)	𒐡	sux
4(gecu@c)	4(GEŠU)	𒐡	sux
4(gec)u)	4(GEŠU)	𒐡	sux
4(gec)u@c)	4(GEŠU)	𒐡	sux
5(gecu)	5(GEŠU)	𒐢	sux
5(gecu@c)	5(GEŠU)	𒐢	sux
5(gec)u)	5(GEŠU)	𒐢	sux
5(gec)u@c)	5(GEŠU)	𒐢	sux
limmu3	4(U)	𒐏	sux
limu3	4(U)	𒐏	sux
nimin	4(U)	𒐏	sux
nimina	4(U)	𒐏	sux
nin5	4(U)	𒐏	sux
nina4	4(U)	𒐏	sux
canabaku2	4(U)	𒐏	sux
canabi2	4(U)	𒐏	sux
4(u)	4(U)	𒐏	sux
4(u@c)	4(U)	𒐏	sux
4(bur3)	4(U)	𒐏	sux
4(bur3@c)	4(U)	𒐏	sux
5(u)	5(U)	𒐐	sux
5(u@c)	5(U)	𒐐	sux
5(bur3)	5(U)	𒐐	sux
5(bur3@c)	5(U)	𒐐	sux
6(u)	6(U)	𒐑	sux
6(u@c)	6(U)	𒐑	sux
6(bur3)	6(U)	𒐑	sux
7(u)	7(U)	𒐒	sux
7(u@c)	7(U)	𒐒	sux
7(bur3)	7(U)	𒐒	sux
8(u)	8(U)	𒐓	sux
8(u@c)	8(U)	𒐓	sux
8(bur3)	8(U)	𒐓	sux
9(u)	9(U)	𒐔	sux
9(u@c)	9(U)	𒐔	sux
9(bur3)	9(U)	𒐔	sux
1/3(dic@c)	F₁	𒑝	sux
2/3(dic@c)	F₂	𒑞	sux
1/8	F₃	𒑟	sux
1/4	F₄	𒑠	sux
1/4(iku)	F₄	𒑠	sux
1/6	F₅	𒑡	sux
1/4	F₆	𒑢	sux
/	P₁	𒑰	sux
:	P₂	𒑱	sux
:"	P₃	𒑲	sux
:.	P₄	𒑳	sux
::	P₅		sux
